kavuddemu	k a v u d d e m u
amulindirako	a m u l i n d i r a k o
babendako	b a b e n d a k o
mukazi	m u k a z i
abali	a b a l i
akayinza	a k a y i n z a
tebalina	t e b a l i n a
lyabaana	l y a b a a n a
enkalu	e n k a l u
bali	b a l i
bandibadde	b a n d i b a d d e
abalimi	a b a l i m i
disitulikiti	d i s i t u l i k i t i
okubuulira	o k u b u u l i r a
zennyonyi	z e n n y o n y i
okufuna	o k u f u n a
tutya	t u t y a
ezaakeberebwa	e z a a k e b e r e b w a
abakwatiddwa	a b a k w a t i d d w a
ge	g e
kwogera	k w o g e r a
zo	z o
basatu	b a s a t u
kye	k y e
gukosezza	g u k o s e z z a
omulenzi	o m u l e n z i
kwakawuka	k w a k a w u k a
omukambwe	o m u k a m b w e
gye	g y e
kuleetera	k u l e e t e r a
kiruma	k i r u m a
babuuzizza	b a b u u z i z z a
ebigaaniddwa	e b i g a a n i d d w a
bye	b y e
essomero	e s s o m e r o
y’omulundi	y ’ o m u l u n d i
esatu	e s a t u
ggwanga	g g w a n g a
olwekirwadde	o l w e k i r w a d d e
beeyongera	b e e y o n g e r a
ejja	e j j a
gwabantu	g w a b a n t u
balwadde	b a l w a d d e
singa	s i n g a
wakawuka	w a k a w u k a
balina	b a l i n a
wessomero	w e s s o m e r o
bammemba	b a m m e m b a
liba	l i b a
biseera	b i s e e r a
gaazo	g a a z o
kunoonyereza	k u n o o n y e r e z a
okuzuulibwamu	o k u z u u l i b w a m u
agira	a g i r a
nti	n t i
okusinziira	o k u s i n z i i r a
olumala	o l u m a l a
embeera	e m b e e r a
eddagala	e d d a g a l a
ensibuko	e n s i b u k o
okusoma	o k u s o m a
kukulira	k u k u l i r a
gw’abaana	g w ’ a b a a n a
enkola	e n k o l a
munno	m u n n o
wabula	w a b u l a
zaaweebwayo	z a a w e e b w a y o
kaabuze	k a a b u z e
kaduukulu	k a d u u k u l u
ensimbi	e n s i m b i
bulamu	b u l a m u
emyaka	e m y a k a
nti	n t i
kano	k a n o
ssaati	s s a a t i
abawonye	a b a w o n y e
mateeka	m a t e e k a
lukiiko	l u k i i k o
nnyingiko	n n y i n g i k o
kolona	k o l o n a
akantu	a k a n t u
tumumma	t u m u m m a
gwabasawo	g w a b a s a w o
akubye	a k u b y e
baasomesebwa	b a a s o m e s e b w a
abazuulwamu	a b a z u u l w a m u
londako	l o n d a k o
abanafu	a b a n a f u
bakunukkiriza	b a k u n u k k i r i z a
engeri	e n g e r i
gwakawuka	g w a k a w u k a
gyabantu	g y a b a n t u
kadde	k a d d e
akakadde	a k a k a d d e
batandise	b a t a n d i s e
bwekuluma	b w e k u l u m a
okweyambisibwa	o k w e y a m b i s i b w a
zokutangira	z o k u t a n g i r a
tuli	t u l i
kyebyobulamu	k y e b y o b u l a m u
yatuweereza	y a t u w e e r e z a
ssenyigga	s s e n y i g g a
gano	g a n o
bw’otyo	b w ’ o t y o
okusibwa	o k u s i b w a
okujulira	o k u j u l i r a
nendwadde	n e n d w a d d e
zaggaddewo	z a g g a d d e w o
lw’awulira	l w ’ a w u l i r a
baggwiira	b a g g w i i r a
atukubiriza	a t u k u b i r i z a
okuzuula	o k u z u u l a
lyakawuka	l y a k a w u k a
kibuga	k i b u g a
by’okwatako	b y ’ o k w a t a k o
konsitityusoni	k o n s i t i t y u s o n i
okwewalibwa	o k w e w a l i b w a
kubeerawo	k u b e e r a w o
lyakozesebwa	l y a k o z e s e b w a
minisitule	m i n i s i t u l e
wabweru	w a b w e r u
mubala	m u b a l a
kufuna	k u f u n a
awo	a w o
akawuka	a k a w u k a
ntambula	n t a m b u l a
ennyumba	e n n y u m b a
akekirwadde	a k e k i r w a d d e
baayo	b a a y o
yansanyusa	y a n s a n y u s a
amaanyi	a m a a n y i
ago	a g o
wano	w a n o
uganda	u g a n d a
bantu	b a n t u
yebyobulamu	y e b y o b u l a m u
ofunamu	o f u n a m u
kaseera	k a s e e r a
eyasoose	e y a s o o s e
terina	t e r i n a
basobola	b a s o b o l a
zongera	z o n g e r a
bakwatiddwa	b a k w a t i d d w a
dubai	d u b a i
obukookolo	o b u k o o k o l o
bw	b w
waka	w a k a
konna	k o n n a
minene	m i n e n e
okuwangula	o k u w a n g u l a
baki	b a k i
okusigala	o k u s i g a l a
kati	k a t i
baagaanira	b a a g a a n i r a
kakawuka	k a k a w u k a
nnina	n n i n a
kaseera	k a s e e r a
looni	l o o n i
kkorona	k k o r o n a
uganda	u g a n d a
kawempe	k a w e m p e
eziyingira	e z i y i n g i r a
abakadde	a b a k a d d e
oli	o l i
okumira	o k u m i r a
g’ekisajja	g ’ e k i s a j j a
kitubala	k i t u b a l a
magoba	m a g o b a
endala	e n d a l a
ebyobulamu	e b y o b u l a m u
kukozesebwa	k u k o z e s e b w a
mwaka	m w a k a
lyomusujja	l y o m u s u j j a
enfaanana	e n f a a n a n a
za	z a
bimuzza	b i m u z z a
gulwayo	g u l w a y o
likola	l i k o l a
omu	o m u
be	b e
alowooza	a l o w o o z a
buli	b u l i
ekitabo	e k i t a b o
zikyaliwo	z i k y a l i w o
yazaalibwa	y a z a a l i b w a
basiimiddwa	b a s i i m i d d w a
amira	a m i r a
omunaanaansi	o m u n a a n a a n s i
omuzannyo	o m u z a n n y o
nsi	n s i
akalango	a k a l a n g o
alina	a l i n a
okusaasaana	o k u s a a s a a n a
agaffe	a g a f f e
okuwona	o k u w o n a
yagambibwa	y a g a m b i b w a
omuggalo	o m u g g a l o
ebadde	e b a d d e
bakakiiko	b a k a k i i k o
lukumi	l u k u m i
ebweru	e b w e r u
basokerwako	b a s o k e r w a k o
eri	e r i
abanoonyi	a b a n o o n y i
kulisitu	k u l i s i t u
okulaba	o k u l a b a
bwa	b w a
kyetaagisa	k y e t a a g i s a
abawagizi	a b a w a g i z i
ezakawuka	e z a k a w u k a
weggwanga	w e g g w a n g a
ogwokuva	o g w o k u v a
bakwenyumirizaamu	b a k w e n y u m i r i z a a m u
lujjudde	l u j j u d d e
kwandiba	k w a n d i b a
omusaala	o m u s a a l a
beenyigira	b e e n y i g i r a
ebiragiro	e b i r a g i r o
okugula	o k u g u l a
nnyonnyola	n n y o n n y o l a
ziteeka	z i t e e k a
okukwatibwa	o k u k w a t i b w a
district	d i s t r i c t
obwerufu	o b w e r u f u
kuzimba	k u z i m b a
okwamaanyi	o k w a m a a n y i
emmotoka	e m m o t o k a
okuyita	o k u y i t a
mpozzi	m p o z z i
yalagira	y a l a g i r a
faayo	f a a y o
abakozi	a b a k o z i
nakawuka	n a k a w u k a
obusookera	o b u s o o k e r a
tasaanye	t a s a a n y e
mukuba	m u k u b a
tanzania	t a n z a n i a
uganda	u g a n d a
olwakola	o l w a k o l a
bwe	b w e
okukeberebwa	o k u k e b e r e b w a
okimanyi	o k i m a n y i
agalimu	a g a l i m u
bambi	b a m b i
eyokwewala	e y o k w e w a l a
kuyinza	k u y i n z a
yobubakko	y o b u b a k k o
byabantu	b y a b a n t u
basigala	b a s i g a l a
byokuziika	b y o k u z i i k a
bwe	b w e
abaganyuzi	a b a g a n y u z i
siwummula	s i w u m m u l a
gasiima	g a s i i m a
okukola	o k u k o l a
tayinza	t a y i n z a
butuufu	b u t u u f u
ssente	s s e n t e
tekannatulumba	t e k a n n a t u l u m b a
gavumenti	g a v u m e n t i
nakolera	n a k o l e r a
mpaayo	m p a a y o
olina	o l i n a
nkulabe	n k u l a b e
okusobozesa	o k u s o b o z e s a
by’okuzaala	b y ’ o k u z a a l a
lwaki	l w a k i
ezirina	e z i r i n a
omugenzi	o m u g e n z i
byonna	b y o n n a
abayizi	a b a y i z i
amabanga	a m a b a n g a
zonna	z o n n a
muntu	m u n t u
banyirira	b a n y i r i r a
ekikola	e k i k o l a
ekitone	e k i t o n e
kuzaalibwa	k u z a a l i b w a
omukambwe	o m u k a m b w e
egisoboka	e g i s o b o k a
ebitundu	e b i t u n d u
kusooka	k u s o o k a
nnagwedda	n n a g w e d d a
n’addirirwa	n ’ a d d i r i r w a
kubanga	k u b a n g a
oluganda	o l u g a n d a
kivunaanyibwa	k i v u n a a n y i b w a
bw’akomawo	b w ’ a k o m a w o
emugga	e m u g g a
yakawuka	y a k a w u k a
akalaga	a k a l a g a
gw’abakazi	g w ’ a b a k a z i
ebirungi	e b i r u n g i
basasulwa	b a s a s u l w a
omuvubuka	o m u v u b u k a
poliisi	p o l i i s i
ddala	d d a l a
okwekebeza	o k w e k e b e z a
okulwanyisa	o k u l w a n y i s a
bagezezzaako	b a g e z e z z a a k o
atabisomye	a t a b i s o m y e
yeeyongera	y e e y o n g e r a
kkeberero	k k e b e r e r o
mukozi	m u k o z i
tutandika	t u t a n d i k a
guvuga	g u v u g a
abangi	a b a n g i
bateekeddwa	b a t e e k e d d w a
okuggalwa	o k u g g a l w a
okusomesa	o k u s o m e s a
embwa	e m b w a
kitundu	k i t u n d u
katonda	k a t o n d a
bujjanjabi	b u j j a n j a b i
endwadde	e n d w a d d e
ekakasa	e k a k a s a
gutya	g u t y a
weekali	w e e k a l i
yantegeeza	y a n t e g e e z a
tebafuddeeyo	t e b a f u d d e e y o
kino	k i n o
kkumi	k k u m i
basiigiddwa	b a s i i g i d d w a
batuuze	b a t u u z e
ennyo	e n n y o
ki	k i
asinga	a s i n g a
talidde	t a l i d d e
bitono	b i t o n o
kufa	k u f a
ekisaawe	e k i s a a w e
bonna	b o n n a
akasiiga	a k a s i i g a
atuula	a t u u l a
baavaayo	b a a v a a y o
kata	k a t a
abasajja	a b a s a j j a
byomuggalo	b y o m u g g a l o
bwagambako	b w a g a m b a k o
mukenenya	m u k e n e n y a
kibuga	k i b u g a
tekitegeeza	t e k i t e g e e z a
ebigezo	e b i g e z o
abasirikirwa	a b a s i r i k i r w a
enguzi	e n g u z i
yeetaba	y e e t a b a
omuntu	o m u n t u
ennamba	e n n a m b a
lwa	l w a
okugemebwa	o k u g e m e b w a
kuba	k u b a
katyabaga	k a t y a b a g a
abawangaala	a b a w a n g a a l a
emmeeme	e m m e e m e
ekibadde	e k i b a d d e
balagajjalirwa	b a l a g a j j a l i r w a
oyige	o y i g e
kye	k y e
ssaalumanya	s s a a l u m a n y a
nabo	n a b o
bamubuulidde	b a m u b u u l i d d e
amasomero	a m a s o m e r o
kusoboka	k u s o b o k a
kano	k a n o
kye	k y e
ngagoba	n g a g o b a
bimenya	b i m e n y a
kwabwe	k w a b w e
gyonna	g y o n n a
ngolina	n g o l i n a
abalina	a b a l i n a
wakiso	w a k i s o
osaana	o s a a n a
bumala	b u m a l a
ekyomukisa	e k y o m u k i s a
abalwadde	a b a l w a d d e
baatukeberanga	b a a t u k e b e r a n g a
omuyizi	o m u y i z i
jjangu	j j a n g u
obwa	o b w a
nomu	n o m u
obutabigendamu	o b u t a b i g e n d a m u
we	w e
nnyo	n n y o
ddwaliro	d d w a l i r o
omulimu	o m u l i m u
byazuulibwamu	b y a z u u l i b w a m u
byetaago	b y e t a a g o
ogenda	o g e n d a
yamusaba	y a m u s a b a
emu	e m u
kwe	k w e
bw’okola	b w ’ o k o l a
okuyimirizaawo	o k u y i m i r i z a a w o
okuziyizamu	o k u z i y i z a m u
abalala	a b a l a l a
yenna	y e n n a
kukola	k u k o l a
omubi	o m u b i
banka	b a n k a
zijja	z i j j a
guleetebwa	g u l e e t e b w a
bazitereka	b a z i t e r e k a
okwambala	o k w a m b a l a
mulamu	m u l a m u
gyetuyinza	g y e t u y i n z a
kyakulya	k y a k u l y a
simulaba	s i m u l a b a
kkubo	k k u b o
ababbi	a b a b b i
kya	k y a
okujja	o k u j j a
okwogeramu	o k w o g e r a m u
fuba	f u b a
gulina	g u l i n a
omuwala	o m u w a l a
ga	g a
abavuzi	a b a v u z i
abapya	a b a p y a
baalowooza	b a a l o w o o z a
okuweebwa	o k u w e e b w a
aweebwa	a w e e b w a
ako	a k o
waliwo	w a l i w o
okuba	o k u b a
ngakawuka	n g a k a w u k a
okubeera	o k u b e e r a
loole	l o o l e
banjagala	b a n j a g a l a
akaleeta	a k a l e e t a
abasaabaze	a b a s a a b a z e
esobola	e s o b o l a
alaga	a l a g a
nokuzaala	n o k u z a a l a
yabadde	y a b a d d e
omubbi	o m u b b i
nnaku	n n a k u
korona	k o r o n a
okusaddaakibwa	o k u s a d d a a k i b w a
omwami	o m w a m i
baatulaze	b a a t u l a z e
okubaawo	o k u b a a w o
kufumbirwa	k u f u m b i r w a
omukyala	o m u k y a l a
okuva	o k u v a
kwambala	k w a m b a l a
muko	m u k o
ago	a g o
era	e r a
zizaala	z i z a a l a
gw’ekika	g w ’ e k i k a
omusajja	o m u s a j j a
tayagala	t a y a g a l a
bakolera	b a k o l e r a
lyabwe	l y a b w e
boogera	b o o g e r a
ddembe	d d e m b e
abamuddako	a b a m u d d a k o
bakeberebwa	b a k e b e r e b w a
muno	m u n o
bwabwe	b w a b w e
awe	a w e
okunaaba	o k u n a a b a
okusaasaana	o k u s a a s a a n a
congo	c o n g o
kugenda	k u g e n d a
zaggyiddwa	z a g g y i d d w a
ezigenda	e z i g e n d a
okwekuuma	o k w e k u u m a
wakamunye	w a k a m u n y e
zabantu	z a b a n t u
tusobola	t u s o b o l a
eyali	e y a l i
okuddamu	o k u d d a m u
n’amuwa	n ’ a m u w a
amawulire	a m a w u l i r e
abatwalira	a b a t w a l i r a
tukubirizibwa	t u k u b i r i z i b w a
olulimi	o l u l i m i
kulonda	k u l o n d a
abakyala	a b a k y a l a
omukulu	o m u k u l u
baabiggalawo	b a a b i g g a l a w o
obumu	o b u m u
nakawuka	n a k a w u k a
namulaba	n a m u l a b a
ebyo	e b y o
bandikosebwa	b a n d i k o s e b w a
kiseera	k i s e e r a
gwa	g w a
yandiba	y a n d i b a
byamuddamu	b y a m u d d a m u
bulungi	b u l u n g i
amagagga	a m a g a g g a
oguwedde	o g u w e d d e
omuzito	o m u z i t o
ensangi	e n s a n g i
okuyamba	o k u y a m b a
omulwadde	o m u l w a d d e
si	s i
eggwanga	e g g w a n g a
omusujja	o m u s u j j a
biyinza	b i y i n z a
kyekisanja	k y e k i s a n j a
mu	m u
omusomesa	o m u s o m e s a
osobola	o s o b o l a
enkungaana	e n k u n g a a n a
okukirizza	o k u k i r i z z a
bulungi	b u l u n g i
biroole	b i r o o l e
omubaka	o m u b a k a
asobola	a s o b o l a
ssomero	s s o m e r o
ensi	e n s i
tewaaliwo	t e w a a l i w o
tebakyafuna	t e b a k y a f u n a
abaaleeta	a b a a l e e t a
omulundi	o m u l u n d i
olwo	o l w o
kagoyerezza	k a g o y e r e z z a
okukwasaganya	o k u k w a s a g a n y a
azannye	a z a n n y e
sampolo	s a m p o l o
mwezi	m w e z i
kufufugaza	k u f u f u g a z a
ogwakattibwa	o g w a k a t t i b w a
togezaako	t o g e z a a k o
nga	n g a
yonna	y o n n a
obubonero	o b u b o n e r o
biyamba	b i y a m b a
nnyo	n n y o
bulungi	b u l u n g i
okukendeeza	o k u k e n d e e z a
okusooka	o k u s o o k a
ebiziyiza	e b i z i y i z a
malwaliro	m a l w a l i r o
abo	a b o
okugikozesa	o k u g i k o z e s a
muyizi	m u y i z i
beebo	b e e b o
omperekereko	o m p e r e k e r e k o
yamuwa	y a m u w a
olaba	o l a b a
ebbali	e b b a l i
bayinza	b a y i n z a
mmeka	m m e k a
	
okwetangiramu	o k w e t a n g i r a m u
ekirwadde	e k i r w a d d e
obwo	o b w o
essomero	e s s o m e r o
mawanga	m a w a n g a
omukazi	o m u k a z i
yemu	y e m u
wampimira	w a m p i m i r a
omukambwe	o m u k a m b w e
munnayuganda	m u n n a y u g a n d a
leero	l e e r o
bannayuganda	b a n n a y u g a n d a
siringi	s i r i n g i
mbeera	m b e e r a
okwekebereza	o k w e k e b e r e z a
nakawangula	n a k a w a n g u l a
okwewa	o k w e w a
byokubaluka	b y o k u b a l u k a
kwekenneenyezebwa	k w e k e n n e e n y e z e b w a
zino	z i n o
yonna	y o n n a
amakulu	a m a k u l u
ebimu	e b i m u
newankubadde	n e w a n k u b a d d e
ebiwuka	e b i w u k a
zandikendeezezza	z a n d i k e n d e e z e z z a
munnange	m u n n a n g e
kafa	k a f a
yategeeza	y a t e g e e z a
bakazi	b a k a z i
abatono	a b a t o n o
ebibinja	e b i b i n j a
abakakiiko	a b a k a k i i k o
b’osobola	b ’ o s o b o l a
wamma	w a m m a
amateeka	a m a t e e k a
emenyese	e m e n y e s e
bobubudamu	b o b u b u d a m u
gomesi	g o m e s i
ye	y e
teweesiga	t e w e e s i g a
zaawerebwa	z a a w e r e b w a
ezimu	e z i m u
ayitiwo	a y i t i w o
nnyo	n n y o
munnabusiro	m u n n a b u s i r o
abasomesa	a b a s o m e s a
wange	w a n g e
abajulizi	a b a j u l i z i
abafa	a b a f a
wa	w a
entebe	e n t e b e
ebintu	e b i n t u
ba	b a
olwokubalukawo	o l w o k u b a l u k a w o
agenda	a g e n d a
okukubisibwamu	o k u k u b i s i b w a m u
mukenenya	m u k e n e n y a
miwendo	m i w e n d o
buyambi	b u y a m b i
baalyekanze	b a a l y e k a n z e
yo	y o
nasaba	n a s a b a
nzirugavu	n z i r u g a v u
ekyokukozesa	e k y o k u k o z e s a
paalamenti	p a a l a m e n t i
kulwanyisa	k u l w a n y i s a
ate	a t e
obulungi	o b u l u n g i
otandika	o t a n d i k a
byabalwadde	b y a b a l w a d d e
mulekwa	m u l e k w a
kyenjega	k y e n j e g a
kolona	k o l o n a
asimbibwa	a s i m b i b w a
kirudde	k i r u d d e
olukiiko	o l u k i i k o
akizudde	a k i z u d d e
obwefaanaanyiriza	o b w e f a a n a a n y i r i z a
okutangira	o k u t a n g i r a
kulina	k u l i n a
nnyingi	n n y i n g i
eyavudde	e y a v u d d e
bagamba	b a g a m b a
mwagala	m w a g a l a
toyagala	t o y a g a l a
yokwekuumamu	y o k w e k u u m a m u
ekisinga	e k i s i n g a
obwawamu	o b w a w a m u
gyasigazza	g y a s i g a z z a
obulungi	o b u l u n g i
kkondo	k k o n d o
omukambwe	o m u k a m b w e
likaawa	l i k a a w a
eziggyayo	e z i g g y a y o
tekirina	t e k i r i n a
birina	b i r i n a
mukyala	m u k y a l a
kusasula	k u s a s u l a
ani	a n i
nokusaba	n o k u s a b a
mwanjo	m w a n j o
tegabaamu	t e g a b a a m u
bakola	b a k o l a
ebikolwa	e b i k o l w a
naye	n a y e
gwazo	g w a z o
etunuulirwa	e t u n u u l i r w a
ne	n e
akazannyo	a k a z a n n y o
okukumiramu	o k u k u m i r a m u
e	e
omusirikale	o m u s i r i k a l e
emmere	e m m e r e
enkonge	e n k o n g e
mirimu	m i r i m u
ca	c a
nabalala	n a b a l a l a
mbuto	m b u t o
kujjanjaba	k u j j a n j a b a
ssennyiga	s s e n n y i g a
yokuziyizamu	y o k u z i y i z a m u
okwetangira	o k w e t a n g i r a
tweyagalidde	t w e y a g a l i d d e
yatwala	y a t w a l a
yagaana	y a g a a n a
kwetuusaako	k w e t u u s a a k o
okimanyi	o k i m a n y i
okutikkirwa	o k u t i k k i r w a
kingi	k i n g i
siriimu	s i r i i m u
corona	c o r o n a
bifo	b i f o
okumanya	o k u m a n y a
kinene	k i n e n e
ezenjawulo	e z e n j a w u l o
ebirango	e b i r a n g o
kafyu	k a f y u
omuli	o m u l i
amateeka	a m a t e e k a
ssenyiga	s s e n y i g a
ekitongole	e k i t o n g o l e
lyakawuka	l y a k a w u k a
bbaasi	b b a a s i
lyabwe	l y a b w e
walina	w a l i n a
kyokuzina	k y o k u z i n a
eryobwebange	e r y o b w e b a n g e
agoomunda	a g o o m u n d a
bo	b o
omu	o m u
n’amaka	n ’ a m a k a
bulemenga	b u l e m e n g a
ku	k u
baali	b a a l i
budde	b u d d e
corona	c o r o n a
eddiini	e d d i i n i
kyatuukako	k y a t u u k a k o
mukakkamu	m u k a k k a m u
yatwalibwa	y a t w a l i b w a
amazzi	a m a z z i
ekirwadde	e k i r w a d d e
emirundi	e m i r u n d i
ngebulamu	n g e b u l a m u
yaziikibwa	y a z i i k i b w a
tegasobola	t e g a s o b o l a
naawe	n a a w e
okugyoza	o k u g y o z a
emyoyo	e m y o y o
ki	k i
ebyensuso	e b y e n s u s o
kyamanyisa	k y a m a n y i s a
abaami	a b a a m i
abaana	a b a a n a
muwandiikiragana	m u w a n d i i k i r a g a n a
abaakafa	a b a a k a f a
kyabazinga	k y a b a z i n g a
okubaako	o k u b a a k o
ebyavudde	e b y a v u d d e
kabonero	k a b o n e r o
nsalo	n s a l o
pulezidenti	p u l e z i d e n t i
lunaku	l u n a k u
kimuleetera	k i m u l e e t e r a
amagezi	a m a g e z i
twakola	t w a k o l a
erimu	e r i m u
ebyakeberebwa	e b y a k e b e r e b w a
amawanga	a m a w a n g a
kyakawuka	k y a k a w u k a
bwamala	b w a m a l a
gaba	g a b a
abalongoosa	a b a l o n g o o s a
olubiri	o l u b i r i
gava	g a v a
akakuubagano	a k a k u u b a g a n o
balamu	b a l a m u
buliwa	b u l i w a
okwesigamya	o k w e s i g a m y a
bateekwa	b a t e e k w a
kumpi	k u m p i
bubonero	b u b o n e r o
okuziyiza	o k u z i y i z a
bizinesi	b i z i n e s i
luggya	l u g g y a
lukokola	l u k o k o l a
kulya	k u l y a
baana	b a a n a
byomujjuzo	b y o m u j j u z o
webuli	w e b u l i
gyogyagalamu	g y o g y a g a l a m u
beeyongedde	b e e y o n g e d d e
ka	k a
bakambwe	b a k a m b w e
yesu	y e s u
kujja	k u j j a
ebyobutujju	e b y o b u t u j j u
bigobererwa	b i g o b e r e r w a
basiibulwa	b a s i i b u l w a
omuzannyi	o m u z a n n y i
mwaka	m w a k a
gavumenti	g a v u m e n t i
banoonyerereza	b a n o o n y e r e r e z a
okwakavuyo	o k w a k a v u y o
gukendeddeko	g u k e n d e d d e k o
basattira	b a s a t t i r a
takyalaba	t a k y a l a b a
weeriri	w e e r i r i
ekifo	e k i f o
yokwewalamu	y o k w e w a l a m u
yange	y a n g e
okuboggola	o k u b o g g o l a
y’asooka	y ’ a s o o k a
bbunansi	b b u n a n s i
kimugwanira	k i m u g w a n i r a
guno	g u n o
ababeera	a b a b e e r a
agamba	a g a m b a
enkya	e n k y a
lwokuwona	l w o k u w o n a
bokulembera	b o k u l e m b e r a
lungi	l u n g i
ssimu	s s i m u
bebitundu	b e b i t u n d u
omuwendo	o m u w e n d o
ngabantu	n g a b a n t u
abamu	a b a m u
musujja	m u s u j j a
yateekebwawo	y a t e e k e b w a w o
lye	l y e
kubeera	k u b e e r a
baakumujjukiranga	b a a k u m u j j u k i r a n g a
alipoota	a l i p o o t a
teyita	t e y i t a
teyebalirira	t e y e b a l i r i r a
okukuumira	o k u k u u m i r a
wankoko	w a n k o k o
zituuse	z i t u u s e
kyabwe	k y a b w e
bulindaala	b u l i n d a a l a
namuli	n a m u l i
yaffe	y a f f e
eyambye	e y a m b y e
teyozebwa	t e y o z e b w a
bwakawuka	b w a k a w u k a
zifiiriziddwa	z i f i i r i z i d d w a
nsimbi	n s i m b i
ddagala	d d a g a l a
nja	n j a
yasoose	y a s o o s e
zakawuka	z a k a w u k a
tulina	t u l i n a
olugezigezi	o l u g e z i g e z i
kibadde	k i b a d d e
bwavu	b w a v u
ngeri	n g e r i
ngero	n g e r o
yeetegese	y e e t e g e s e
obulwadde	o b u l w a d d e
eba	e b a
okulonda	o k u l o n d a
abakulembeze	a b a k u l e m b e z e
muwogo	m u w o g o
mboozi	m b o o z i
okutuusa	o k u t u u s a
emiganyulo	e m i g a n y u l o
obujjanjabi	o b u j j a n j a b i
nabuuka	n a b u u k a
gw’ozaaala	g w ’ o z a a a l a
lwomwana	l w o m w a n a
bakawuka	b a k a w u k a
yayita	y a y i t a
kwongera	k w o n g e r a
omusawo	o m u s a w o
buvunaanyizibwa	b u v u n a a n y i z i b w a
okwetaba	o k w e t a b a
obukulu	o b u k u l u
muganda	m u g a n d a
kyeyo	k y e y o
ozikozese	o z i k o z e s e
aka	a k a
ebifo	e b i f o
egaanye	e g a a n y e
buwundo	b u w u n d o
liriwa	l i r i w a
agakumala	a g a k u m a l a
batya	b a t y a
ebola	e b o l a
yokuziyiza	y o k u z i y i z a
baabwe	b a a b w e
nkwaso	n k w a s o
bwammwe	b w a m m w e
tebikyasomebwa	t e b i k y a s o m e b w a
boludda	b o l u d d a
ggwanga	g g w a n g a
ensalo	e n s a l o
tebyawera	t e b y a w e r a
eddagala	e d d a g a l a
batte	b a t t e
embiriizi	e m b i r i i z i
kwamasomero	k w a m a s o m e r o
tukuleetedde	t u k u l e e t e d d e
luli	l u l i
abasinga	a b a s i n g a
mwekuumenga	m w e k u u m e n g a
oluvannyuma	o l u v a n n y u m a
omupya	o m u p y a
oyo	o y o
zaali	z a a l i
ngalo	n g a l o
balangiddwa	b a l a n g i d d w a
weetaaga	w e e t a a g a
ebbanga	e b b a n g a
nobubbi	n o b u b b i
okusomesebwa	o k u s o m e s e b w a
akawuka	a k a w u k a
ffe	f f e
ebeera	e b e e r a
bantu	b a n t u
tolina	t o l i n a
abazuuliddwamu	a b a z u u l i d d w a m u
abatuuze	a b a t u u z e
ennaku	e n n a k u
wasobola	w a s o b o l a
empale	e m p a l e
katagaza	k a t a g a z a
enjaga	e n j a g a
baawa	b a a w a
kakunyumidde	k a k u n y u m i d d e
mulimu	m u l i m u
nebifo	n e b i f o
okuviirako	o k u v i i r a k o
nnaleese	n n a l e e s e
muliraano	m u l i r a a n o
zaggalwa	z a g g a l w a
okulya	o k u l y a
muwogo	m u w o g o
gulinnya	g u l i n n y a
okukozesa	o k u k o z e s a
tagoberedde	t a g o b e r e d d e
bangi	b a n g i
obuyinza	o b u y i n z a
gwe	g w e
okulwana	o k u l w a n a
nnaabakyala	n n a a b a k y a l a
baazuuliddwamu	b a a z u u l i d d w a m u
bategekeddwa	b a t e g e k e d d w a
tegeeza	t e g e e z a
kimuggyako	k i m u g g y a k o
omwana	o m w a n a
oba	o b a
ezeetagisa	e z e e t a g i s a
yabantu	y a b a n t u
entambula	e n t a m b u l a
ziteereddwawo	z i t e e r e d d w a w o
okutuuka	o k u t u u k a
gwomukaaga	g w o m u k a a g a
bikolwa	b i k o l w a
mwe	m w e
ko	k o
okwongera	o k w o n g e r a
obulwadde	o b u l w a d d e
okukikozesa	o k u k i k o z e s a
obwobuntu	o b w o b u n t u
amagye	a m a g y e
yaleeta	y a l e e t a
yali	y a l i
nsuubira	n s u u b i r a
ebalese	e b a l e s e
omulanga	o m u l a n g a
ebitangira	e b i t a n g i r a
bakusobera	b a k u s o b e r a
nnyini	n n y i n i
njambalirawo	n j a m b a l i r a w o
eyakoze	e y a k o z e
mutono	m u t o n o
kwakawuka	k w a k a w u k a
vayirasi	v a y i r a s i
zo	z o
mulyango	m u l y a n g o
tegeka	t e g e k a
okusaasaanya	o k u s a a s a a n y a
kituufu	k i t u u f u
butujjukiza	b u t u j j u k i z a
kizibu	k i z i b u
nsonga	n s o n g a
omukwambwe	o m u k w a m b w e
zino	z i n o
mbadde	m b a d d e
ekyakawuka	e k y a k a w u k a
abasawo	a b a s a w o
kweyongedde	k w e y o n g e d d e
okwanguyaako	o k w a n g u y a a k o
byobulimi	b y o b u l i m i
abantu	a b a n t u
abato	a b a t o
katikkiro	k a t i k k i r o
yavunaaniddwa	y a v u n a a n i d d w a
okusomera	o k u s o m e r a
olwakawuka	o l w a k a w u k a
njeru	n j e r u
okusiigibwa	o k u s i i g i b w a
lubuto	l u b u t o
ttano	t t a n o
obulabe	o b u l a b e
awaka	a w a k a
basobole	b a s o b o l e
mingi	m i n g i
bavudde	b a v u d d e
okweyongera	o k w e y o n g e r a
byabwe	b y a b w e
