obumanyifu	o b u m a n y i f u
poliisi	p o l i i s i
babendako	b a b e n d a k o
kirina	k i r i n a
buntu	b u n t u
paalamenti	p a a l a m e n t i
bulijjo	b u l i j j o
amaanyi	a m a a n y i
abaabalonda	a b a a b a l o n d a
obujjanjabi	o b u j j a n j a b i
ge	g e
bannannyini	b a n n a n n y i n i
okulwanirira	o k u l w a n i r i r a
okumaliriza	o k u m a l i r i z a
ssaagala	s s a a g a l a
olabe	o l a b e
tebakuyamba	t e b a k u y a m b a
gutya	g u t y a
yakyusibwa	y a k y u s i b w a
baana	b a a n a
agenjawulo	a g e n j a w u l o
wa	w a
ng’erinnya	n g ’ e r i n n y a
oluyimba	o l u y i m b a
yalumya	y a l u m y a
bagezezzaako	b a g e z e z z a a k o
wemyaka	w e m y a k a
baggya	b a g g y a
mazzi	m a z z i
bandekeddewo	b a n d e k e d d e w o
obubudamo	o b u b u d a m o
ebintu	e b i n t u
agenjawulo	a g e n j a w u l o
abagyemera	a b a g y e m e r a
ebiruma	e b i r u m a
buteerere	b u t e e r e r e
emigaati	e m i g a a t i
abazaala	a b a z a a l a
abanyaguluzi	a b a n y a g u l u z i
omukono	o m u k o n o
bwabwe	b w a b w e
essomero	e s s o m e r o
yassa	y a s s a
tebakwatibwa	t e b a k w a t i b w a
okubeera	o k u b e e r a
nayo	n a y o
emiti	e m i t i
beewola	b e e w o l a
bya	b y a
oba	o b a
ebingi	e b i n g i
okugabana	o k u g a b a n a
emikolo	e m i k o l o
lwayabizibwa	l w a y a b i z i b w a
bakuume	b a k u u m e
amatooke	a m a t o o k e
ttendo	t t e n d o
ejja	e j j a
abagikozesa	a b a g i k o z e s a
olubuto	o l u b u t o
abaliyo	a b a l i y o
kwesiga	k w e s i g a
okufa	o k u f a
eriwo	e r i w o
wokunoonya	w o k u n o o n y a
kuzannya	k u z a n n y a
omugwira	o m u g w i r a
bokulembera	b o k u l e m b e r a
zamasomero	z a m a s o m e r o
bagezaako	b a g e z a a k o
namalirirdde	n a m a l i r i r d d e
yasabye	y a s a b y e
mutukoledde	m u t u k o l e d d e
wakamunye	w a k a m u n y e
okufuna	o k u f u n a
bbunansi	b b u n a n s i
bavubuka	b a v u b u k a
ekibuga	e k i b u g a
londako	l o n d a k o
kibi	k i b i
nakawuka	n a k a w u k a
mbonaabona	m b o n a a b o n a
bakwataganye	b a k w a t a g a n y e
omukakkamu	o m u k a k k a m u
aboobuyinza	a b o o b u y i n z a
ziteereddwawo	z i t e e r e d d w a w o
tebaweebwa	t e b a w e e b w a
baasanyukira	b a a s a n y u k i r a
ekitone	e k i t o n e
kabamba	k a b a m b a
okubalukawo	o k u b a l u k a w o
tujja	t u j j a
eyeddiiro	e y e d d i i r o
akapande	a k a p a n d e
galina	g a l i n a
yanditubikulidde	y a n d i t u b i k u l i d d e
gensolo	g e n s o l o
abakuba	a b a k u b a
ayanise	a y a n i s e
n’olw’ensonga	n ’ o l w ’ e n s o n g a
abakola	a b a k o l a
mulungi	m u l u n g i
ebalese	e b a l e s e
bwobulimi	b w o b u l i m i
abaalumbye	a b a a l u m b y e
ekikula	e k i k u l a
zaali	z a a l i
abawamba	a b a w a m b a
okukeberebwa	o k u k e b e r e b w a
ttaano	t t a a n o
kwekuba	k w e k u b a
ebikola	e b i k o l a
wabula	w a b u l a
okukkaatiriza	o k u k k a a t i r i z a
bulwadde	b u l w a d d e
baagabira	b a a g a b i r a
yakwata	y a k w a t a
bigambo	b i g a m b o
akoowodde	a k o o w o d d e
yaleeta	y a l e e t a
okuyambibwa	o k u y a m b i b w a
ebikwatagana	e b i k w a t a g a n a
amasomero	a m a s o m e r o
okuvuvungana	o k u v u v u n g a n a
wansi	w a n s i
abafa	a b a f a
yeesigamizibwa	y e e s i g a m i z i b w a
bw’eteekebwamu	b w ’ e t e e k e b w a m u
baakumujjukiranga	b a a k u m u j j u k i r a n g a
mbi	m b i
pulogulaamu	p u l o g u l a a m u
bwomukulembeze	b w o m u k u l e m b e z e
bakyetaba	b a k y e t a b a
luno	l u n o
nnyinyonnyolero	n n y i n y o n n y o l e r o
ttaka	t t a k a
byobulimi	b y o b u l i m i
nkwaso	n k w a s o
butonde	b u t o n d e
obusuulu	o b u s u u l u
yendya	y e n d y a
tebannazifuna	t e b a n n a z i f u n a
ng’ogezaako	n g ’ o g e z a a k o
ngobulamu	n g o b u l a m u
tuli	t u l i
omulambo	o m u l a m b o
empapula	e m p a p u l a
egiri	e g i r i
guwooma	g u w o o m a
nabbosa	n a b b o s a
byolina	b y o l i n a
kugumira	k u g u m i r a
emyoyo	e m y o y o
kutegeeza	k u t e g e e z a
ogeraageranye	o g e r a a g e r a n y e
tagoberedde	t a g o b e r e d d e
ekyalo	e k y a l o
engero	e n g e r o
omwoleso	o m w o l e s o
enteekateeka	e n t e e k a t e e k a
minisita	m i n i s i t a
ekibonerezo	e k i b o n e r e z o
avuddeyo	a v u d d e y o
emmere	e m m e r e
lyabwe	l y a b w e
ebigaaniddwa	e b i g a a n i d d w a
okwekalakaasa	o k w e k a l a k a a s a
kumulesa	k u m u l e s a
kyaffe	k y a f f e
kukubaganya	k u k u b a g a n y a
nabuuka	n a b u u k a
kcca	k c c a
basigala	b a s i g a l a
emisango	e m i s a n g o
nekitta	n e k i t t a
nabaana	n a b a a n a
gyozikoledde	g y o z i k o l e d d e
gwobusawo	g w o b u s a w o
tweyagalidde	t w e y a g a l i d d e
asukka	a s u k k a
baabadde	b a a b a d d e
okusibwa	o k u s i b w a
obukiikirizi	o b u k i i k i r i z i
neewunya	n e e w u n y a
abaali	a b a a l i
kusembezebwa	k u s e m b e z e b w a
okusitula	o k u s i t u l a
barracks	b a r r a c k s
luba	l u b a
guno	g u n o
basigadde	b a s i g a d d e
mbuto	m b u t o
bulungi	b u l u n g i
balwadde	b a l w a d d e
yekinnansi	y e k i n n a n s i
bo	b o
ebyennaku	e b y e n n a k u
ddala	d d a l a
essuubi	e s s u u b i
nokukyusa	n o k u k y u s a
okukifunamu	o k u k i f u n a m u
n’asukka	n ’ a s u k k a
mmeka	m m e k a
ebikaabya	e b i k a a b y a
buzibu	b u z i b u
bateekeddwa	b a t e e k e d d w a
nkulabe	n k u l a b e
kikulaakulanye	k i k u l a a k u l a n y e
nnonda	n n o n d a
bakulu	b a k u l u
empewo	e m p e w o
takisi	t a k i s i
okwetangiramu	o k w e t a n g i r a m u
yalokola	y a l o k o l a
abatwetooloodde	a b a t w e t o o l o o d d e
bameka	b a m e k a
okukimanya	o k u k i m a n y a
yagaana	y a g a a n a
okunyweza	o k u n y w e z a
okuddayo	o k u d d a y o
okwennaku	o k w e n n a k u
tugiryako	t u g i r y a k o
nga	n g a
bannaddiini	b a n n a d d i i n i
namalwaliro	n a m a l w a l i r o
kyasobola	k y a s o b o l a
ekitabo	e k i t a b o
olubiri	o l u b i r i
balemererwa	b a l e m e r e r w a
mmeka	m m e k a
omupiira	o m u p i i r a
bokufuna	b o k u f u n a
okubalukawo	o k u b a l u k a w o
luvaamu	l u v a a m u
baalwanirira	b a a l w a n i r i r a
amira	a m i r a
bateekwa	b a t e e k w a
biteekwa	b i t e e k w a
eddwadde	e d d w a d d e
amagatte	a m a g a t t e
ngatandika	n g a t a n d i k a
omupiira	o m u p i i r a
gyabantu	g y a b a n t u
yasuula	y a s u u l a
banaakulaba	b a n a a k u l a b a
bamulekwa	b a m u l e k w a
kirudde	k i r u d d e
egezaako	e g e z a a k o
birime	b i r i m e
ebibanja	e b i b a n j a
abakulembeeze	a b a k u l e m b e e z e
abasigadde	a b a s i g a d d e
ebiseera	e b i s e e r a
kulaba	k u l a b a
obubbi	o b u b b i
tebajja	t e b a j j a
eggwanga	e g g w a n g a
kutulugunya	k u t u l u g u n y a
goofu	g o o f u
tebakirizibwa	t e b a k i r i z i b w a
nabantu	n a b a n t u
obunafu	o b u n a f u
gwokubaka	g w o k u b a k a
endowooza	e n d o w o o z a
nensero	n e n s e r o
nokubakubiriza	n o k u b a k u b i r i z a
nsaasaana	n s a a s a a n a
ngali	n g a l i
cricket	c r i c k e t
gaggalawo	g a g g a l a w o
omukago	o m u k a g o
abamanyi	a b a m a n y i
emirimu	e m i r i m u
tegeeza	t e g e e z a
kulowooza	k u l o w o o z a
bawadde	b a w a d d e
kika	k i k a
ndiga	n d i g a
mengo	m e n g o
platform	p l a t f o r m
tekiba	t e k i b a
emiganyulo	e m i g a n y u l o
yatuukirira	y a t u u k i r i r a
okuwa	o k u w a
bitufuula	b i t u f u u l a
gyenviiri	g y e n v i i r i
nebinyeebwa	n e b i n y e e b w a
obukookolo	o b u k o o k o l o
	
tosaanye	t o s a a n y e
ebanjibwa	e b a n j i b w a
ezimu	e z i m u
kata	k a t a
kirala	k i r a l a
engeri	e n g e r i
ezirina	e z i r i n a
neddembe	n e d d e m b e
tulaba	t u l a b a
baasisinkana	b a a s i s i n k a n a
okusigala	o k u s i g a l a
nzeka	n z e k a
bwagwo	b w a g w o
edda	e d d a
lirina	l i r i n a
okuwangula	o k u w a n g u l a
lino	l i n o
ekimuggye	e k i m u g g y e
yokukendeeza	y o k u k e n d e e z a
kutegeerebwa	k u t e g e e r e b w a
okwesumulula	o k w e s u m u l u l a
misango	m i s a n g o
okugula	o k u g u l a
zeetaga	z e e t a g a
gakosezza	g a k o s e z z a
korona	k o r o n a
ezessimba	e z e s s i m b a
muganzi	m u g a n z i
natwalibwa	n a t w a l i b w a
lwenkambi	l w e n k a m b i
kimaanya	k i m a a n y a
yagaana	y a g a a n a
wabula	w a b u l a
nabo	n a b o
teekako	t e e k a k o
nsoma	n s o m a
zettaka	z e t t a k a
basigaleyo	b a s i g a l e y o
amakulu	a m a k u l u
yansobera	y a n s o b e r a
ziyisibwa	z i y i s i b w a
bagula	b a g u l a
gutuleetera	g u t u l e e t e r a
munnange	m u n n a n g e
gy’ayanukulamu	g y ’ a y a n u k u l a m u
ppaka	p p a k a
okutegeera	o k u t e g e e r a
abaaleeta	a b a a l e e t a
kyetaagisa	k y e t a a g i s a
beekobaana	b e e k o b a a n a
kutegeega	k u t e g e e g a
byamazzi	b y a m a z z i
balaba	b a l a b a
baaweebwa	b a a w e e b w a
miti	m i t i
okusamba	o k u s a m b a
eri	e r i
kukuleetera	k u k u l e e t e r a
kukuuma	k u k u u m a
abaabwe	a b a a b w e
baafulumizza	b a a f u l u m i z z a
za	z a
lujjudde	l u j j u d d e
okumalawo	o k u m a l a w o
bakakiiko	b a k a k i i k o
ebyamaguzi	e b y a m a g u z i
byabaganda	b y a b a g a n d a
kulonda	k u l o n d a
balongo	b a l o n g o
okwewala	o k w e w a l a
litasobola	l i t a s o b o l a
n’agatalina	n ’ a g a t a l i n a
ezisaabaza	e z i s a a b a z a
obulwadde	o b u l w a d d e
kibayambye	k i b a y a m b y e
yabyogedde	y a b y o g e d d e
bajjanjabamu	b a j j a n j a b a m u
yegulira	y e g u l i r a
bwe	b w e
omwanawo	o m w a n a w o
obusosoze	o b u s o s o z e
data	d a t a
ezitannabaweebwa	e z i t a n n a b a w e e b w a
baatuyingiridde	b a a t u y i n g i r i d d e
enzimba	e n z i m b a
balwebulungula	b a l w e b u l u n g u l a
mukusiga	m u k u s i g a
yolungereza	y o l u n g e r e z a
obutonde	o b u t o n d e
omulenzi	o m u l e n z i
egyennaku	e g y e n n a k u
gyamawulire	g y a m a w u l i r e
kwessomero	k w e s s o m e r o
bebyobuwanga	b e b y o b u w a n g a
teweesiga	t e w e e s i g a
muwogo	m u w o g o
tebafunye	t e b a f u n y e
awantu	a w a n t u
okuliisibwa	o k u l i i s i b w a
okuboggola	o k u b o g g o l a
okunoonya	o k u n o o n y a
takyalaba	t a k y a l a b a
zonna	z o n n a
okugatta	o k u g a t t a
beesimbyewo	b e e s i m b y e w o
ssaawa	s s a a w a
wamawanga	w a m a w a n g a
bwomanya	b w o m a n y a
bange	b a n g e
okulinnyisibwa	o k u l i n n y i s i b w a
miramwa	m i r a m w a
dokira	d o k i r a
abawangaala	a b a w a n g a a l a
nafa	n a f a
wo	w o
abakyali	a b a k y a l i
gulinnya	g u l i n n y a
okwanguya	o k w a n g u y a
okulwana	o k u l w a n a
looni	l o o n i
gyekitundu	g y e k i t u n d u
abakulembeze	a b a k u l e m b e z e
keetaaga	k e e t a a g a
kukubirizibwa	k u k u b i r i z i b w a
abasirikale	a b a s i r i k a l e
endagamuntu	e n d a g a m u n t u
asinzidde	a s i n z i d d e
beetobya	b e e t o b y a
entongole	e n t o n g o l e
omwenge	o m w e n g e
kyokugenda	k y o k u g e n d a
obusawo	o b u s a w o
ekikopo	e k i k o p o
baalinnyisizza	b a a l i n n y i s i z z a
kavuddemu	k a v u d d e m u
okusembeza	o k u s e m b e z a
ekikuumabyalo	e k i k u u m a b y a l o
tetubifunye	t e t u b i f u n y e
akali	a k a l i
ebikuweereddwa	e b i k u w e e r e d d w a
wabweru	w a b w e r u
bantu	b a n t u
namakulu	n a m a k u l u
bavuba	b a v u b a
kasiki	k a s i k i
nnamugambye	n n a m u g a m b y e
nasalawo	n a s a l a w o
bw’ensi	b w ’ e n s i
kwobuweereza	k w o b u w e e r e z a
kano	k a n o
obufuniddwa	o b u f u n i d d w a
anti	a n t i
abasumba	a b a s u m b a
nensonga	n e n s o n g a
gikoleddwa	g i k o l e d d w a
sigenda	s i g e n d a
kyatabudde	k y a t a b u d d e
lwembaga	l w e m b a g a
yayanjudde	y a y a n j u d d e
embeerabantu	e m b e e r a b a n t u
teesa	t e e s a
emiti	e m i t i
bakubiddwa	b a k u b i d d w a
bakwatiddwa	b a k w a t i d d w a
lwabantu	l w a b a n t u
okusaba	o k u s a b a
kusangibwa	k u s a n g i b w a
omwaka	o m w a k a
buganda	b u g a n d a
eyatusibwako	e y a t u s i b w a k o
kintu	k i n t u
etaddewo	e t a d d e w o
okugezza	o k u g e z z a
kiba	k i b a
lyani	l y a n i
entebenkevu	e n t e b e n k e v u
abbey	a b b e y
kit	k i t
baakangavuudde	b a a k a n g a v u u d d e
kwabantu	k w a b a n t u
mitima	m i t i m a
bwensimbi	b w e n s i m b i
kwabaneetaba	k w a b a n e e t a b a
yakubirizza	y a k u b i r i z z a
kampala	k a m p a l a
okubuulirira	o k u b u u l i r i r a
emisono	e m i s o n o
ngalo	n g a l o
giyitibwamu	g i y i t i b w a m u
bukookolo	b u k o o k o l o
ebigezo	e b i g e z o
baabulijjo	b a a b u l i j j o
abatono	a b a t o n o
woofiisi	w o o f i i s i
okusuubiza	o k u s u u b i z a
ngabasomesa	n g a b a s o m e s a
mmwe	m m w e
ekyakawuka	e k y a k a w u k a
disitulikiti	d i s i t u l i k i t i
nokulaga	n o k u l a g a
ntandikwa	n t a n d i k w a
abassajja	a b a s s a j j a
kyangu	k y a n g u
ennyindo	e n n y i n d o
bukomyewo	b u k o m y e w o
ebisago	e b i s a g o
zirina	z i r i n a
engulu	e n g u l u
byeddagala	b y e d d a g a l a
okwagazisa	o k w a g a z i s a
abangi	a b a n g i
obutuufu	o b u t u u f u
waggulu	w a g g u l u
kigezo	k i g e z o
zi	z i
kugamba	k u g a m b a
yabbira	y a b b i r a
sikikusuubira	s i k i k u s u u b i r a
omuzannyo	o m u z a n n y o
abajja	a b a j j a
nokukuba	n o k u k u b a
kuwasa	k u w a s a
abiri	a b i r i
yannyonnyodde	y a n n y o n n y o d d e
y’abantu	y ’ a b a n t u
ebisale	e b i s a l e
obugagga	o b u g a g g a
ffenna	f f e n n a
konsitityusoni	k o n s i t i t y u s o n i
nomutemu	n o m u t e m u
bakadde	b a k a d d e
wasomera	w a s o m e r a
wakati	w a k a t i
gebweru	g e b w e r u
yaffe	y a f f e
naziggya	n a z i g g y a
amadaala	a m a d a a l a
kya	k y a
kyakulya	k y a k u l y a
obwavu	o b w a v u
abakungu	a b a k u n g u
ziwoomerwa	z i w o o m e r w a
ekinusu	e k i n u s u
okuddamu	o k u d d a m u
bawuddiise	b a w u d d i i s e
balwadde	b a l w a d d e
omuliro	o m u l i r o
biseera	b i s e e r a
okubba	o k u b b a
ca	c a
mulyango	m u l y a n g o
abazuuliddwamu	a b a z u u l i d d w a m u
basonze	b a s o n z e
balumbamu	b a l u m b a m u
abasoba	a b a s o b a
byabantu	b y a b a n t u
ebbula	e b b u l a
tezikyajja	t e z i k y a j j a
mikolo	m i k o l o
okumanya	o k u m a n y a
bwo	b w o
aweese	a w e e s e
ebyobufuzi	e b y o b u f u z i
yatiddwa	y a t i d d w a
lyava	l y a v a
okugonjoola	o k u g o n j o o l a
ntaana	n t a a n a
akawera	a k a w e r a
okwegomba	o k w e g o m b a
okutebenkeza	o k u t e b e n k e z a
bweru	b w e r u
okusinga	o k u s i n g a
corona	c o r o n a
ekkubo	e k k u b o
olwo	o l w o
ebyabiddwa	e b y a b i d d w a
okwogeramu	o k w o g e r a m u
olukiiko	o l u k i i k o
bakuggyamu	b a k u g g y a m u
bwasabye	b w a s a b y e
yalabudde	y a l a b u d d e
waggwa	w a g g w a
nnya	n n y a
kusobola	k u s o b o l a
okunywa	o k u n y w a
obulwadde	o b u l w a d d e
okutta	o k u t t a
yensimbi	y e n s i m b i
bwobwongo	b w o b w o n g o
ebyobulimi	e b y o b u l i m i
kyalo	k y a l o
zikozesebwa	z i k o z e s e b w a
kiggyeko	k i g g y e k o
obukiikakkono	o b u k i i k a k k o n o
keenyinyimbwa	k e e n y i n y i m b w a
abaazeerimira	a b a a z e e r i m i r a
pulasitiika	p u l a s i t i i k a
bino	b i n o
zeddiini	z e d d i i n i
ogusinga	o g u s i n g a
eyeesimbyewo	e y e e s i m b y e w o
abazannyi	a b a z a n n y i
nabalenzi	n a b a l e n z i
bokka	b o k k a
bigezo	b i g e z o
nabanoonyi	n a b a n o o n y i
nabalala	n a b a l a l a
bitundu	b i t u n d u
g’abantu	g ’ a b a n t u
olwokulwanirira	o l w o k u l w a n i r i r a
panyimur	p a n y i m u r
ddagala	d d a g a l a
lwe	l w e
y’abyogera	y ’ a b y o g e r a
obuseere	o b u s e e r e
betaaga	b e t a a g a
ebiruubirirwa	e b i r u u b i r i r w a
ffenna	f f e n n a
mpuku	m p u k u
tweyongera	t w e y o n g e r a
mugulansigo	m u g u l a n s i g o
kyetaaga	k y e t a a g a
okutabula	o k u t a b u l a
kamu	k a m u
okwenyigiramu	o k w e n y i g i r a m u
olungereza	o l u n g e r e z a
ogwo	o g w o
kuba	k u b a
kyali	k y a l i
olwatuuka	o l w a t u u k a
bakyagenda	b a k y a g e n d a
n’omukyuso	n ’ o m u k y u s o
kakazigizigi	k a k a z i g i z i g i
oluusi	o l u u s i
okufuuka	o k u f u u k a
baakyogerako	b a a k y o g e r a k o
lukujjukujju	l u k u j j u k u j j u
tebeesiga	t e b e e s i g a
ensa	e n s a
byonna	b y o n n a
baakiraba	b a a k i r a b a
bwenkana	b w e n k a n a
bwoweereza	b w o w e e r e z a
okubazza	o k u b a z z a
kisaana	k i s a a n a
kafyu	k a f y u
obuzibu	o b u z i b u
ataasizza	a t a a s i z z a
okulonda	o k u l o n d a
okumanyisa	o k u m a n y i s a
tekunnatuuka	t e k u n n a t u u k a
erina	e r i n a
obutaba	o b u t a b a
gaba	g a b a
bagamba	b a g a m b a
okwenyigira	o k w e n y i g i r a
ebigasa	e b i g a s a
kiri	k i r i
bannamateeka	b a n n a m a t e e k a
baweebwe	b a w e e b w e
ebyetaago	e b y e t a a g o
lw’awulira	l w ’ a w u l i r a
omuyizi	o m u y i z i
bakansala	b a k a n s a l a
butuuseeko	b u t u u s e e k o
okuvaayo	o k u v a a y o
abakoseddwa	a b a k o s e d d w a
okwesigamya	o k w e s i g a m y a
abalimi	a b a l i m i
obukambwe	o b u k a m b w e
yebigambo	y e b i g a m b o
mulamu	m u l a m u
obwongo	o b w o n g o
bagenze	b a g e n z e
enkulaakulana	e n k u l a a k u l a n a
bitera	b i t e r a
kulonda	k u l o n d a
baasuubulanga	b a a s u u b u l a n g a
afuuweeta	a f u u w e e t a
byokuziika	b y o k u z i i k a
banna	b a n n a
eyimbule	e y i m b u l e
ekiraamo	e k i r a a m o
so	s o
kyonna	k y o n n a
zensi	z e n s i
y’embeerabantu	y ’ e m b e e r a b a n t u
esomesebwa	e s o m e s e b w a
eweddemu	e w e d d e m u
muyizi	m u y i z i
nenkulaakulana	n e n k u l a a k u l a n a
nkungaana	n k u n g a a n a
akaddiwa	a k a d d i w a
wayagalira	w a y a g a l i r a
abakuumi	a b a k u u m i
wekyalo	w e k y a l o
dipulooma	d i p u l o o m a
twakizuula	t w a k i z u u l a
nzaalibwa	n z a a l i b w a
bemisango	b e m i s a n g o
tebannatandika	t e b a n n a t a n d i k a
abaayingidde	a b a a y i n g i d d e
kyaggwamu	k y a g g w a m u
lyabantu	l y a b a n t u
eky’okunywa	e k y ’ o k u n y w a
kyomuzannyo	k y o m u z a n n y o
saba	s a b a
mukazi	m u k a z i
basabye	b a s a b y e
hajji	h a j j i
mukaaga	m u k a a g a
esimwa	e s i m w a
okwaniriza	o k w a n i r i z a
kabonero	k a b o n e r o
baagala	b a a g a l a
bitumbuddwa	b i t u m b u d d w a
kituufu	k i t u u f u
nobuzibu	n o b u z i b u
eyambye	e y a m b y e
atuwadde	a t u w a d d e
akabanje	a k a b a n j e
okujja	o k u j j a
omusuubira	o m u s u u b i r a
obayambe	o b a y a m b e
baabwe	b a a b w e
toyagala	t o y a g a l a
bavuddeyo	b a v u d d e y o
kungaanya	k u n g a a n y a
eryali	e r y a l i
egyenjawulo	e g y e n j a w u l o
bakizuula	b a k i z u u l a
nnambogo	n n a m b o g o
byabalimi	b y a b a l i m i
gw’ekika	g w ’ e k i k a
wabaserikale	w a b a s e r i k a l e
egyenkanankana	e g y e n k a n a n k a n a
ebiragiro	e b i r a g i r o
y’asooka	y ’ a s o o k a
okukkaanya	o k u k k a a n y a
kulina	k u l i n a
olaba	o l a b a
bwabantu	b w a b a n t u
kuno	k u n o
okuwumula	o k u w u m u l a
buyitibwa	b u y i t i b w a
nobwongo	n o b w o n g o
abakulisitaayo	a b a k u l i s i t a a y o
okuzuula	o k u z u u l a
okulekera	o k u l e k e r a
yeetuze	y e e t u z e
nabo	n a b o
bwonna	b w o n n a
azannye	a z a n n y e
nakifuura	n a k i f u u r a
okusomesebwa	o k u s o m e s e b w a
muddo	m u d d o
baakolanga	b a a k o l a n g a
bulimi	b u l i m i
kansuubire	k a n s u u b i r e
bbaawe	b b a a w e
bulaaya	b u l a a y a
njagala	n j a g a l a
ategeera	a t e g e e r a
ssente	s s e n t e
yeriwa	y e r i w a
empavu	e m p a v u
okwambala	o k w a m b a l a
kwonoona	k w o n o o n a
okusiba	o k u s i b a
nakatundutundu	n a k a t u n d u t u n d u
ebirime	e b i r i m e
kkondo	k k o n d o
ngekimu	n g e k i m u
okulyazaamaanya	o k u l y a z a a m a a n y a
okugondera	o k u g o n d e r a
oluguudo	o l u g u u d o
okuwuliziganya	o k u w u l i z i g a n y a
weewola	w e e w o l a
okusimba	o k u s i m b a
liwa	l i w a
kolona	k o l o n a
obw’embeerabantu	o b w ’ e m b e e r a b a n t u
amasiro	a m a s i r o
abolugambo	a b o l u g a m b o
bamutunuulidde	b a m u t u n u u l i d d e
eyamba	e y a m b a
nnanyini	n n a n y i n i
yokutangiramu	y o k u t a n g i r a m u
obwana	o b w a n a
byomuggalo	b y o m u g g a l o
uganda	u g a n d a
okwa	o k w a
beerabira	b e e r a b i r a
yassaawo	y a s s a a w o
yakyusa	y a k y u s a
bafa	b a f a
okuyingira	o k u y i n g i r a
okutegeeza	o k u t e g e e z a
okusalawo	o k u s a l a w o
bazigabana	b a z i g a b a n a
nabyo	n a b y o
kyolina	k y o l i n a
kukulira	k u k u l i r a
sso	s s o
okulwala	o k u l w a l a
olusuku	o l u s u k u
manvuuli	m a n v u u l i
ebyuuma	e b y u u m a
ggwanga	g g w a n g a
kuyigirizibwa	k u y i g i r i z i b w a
enkyukakyuka	e n k y u k a k y u k a
nali	n a l i
mitendera	m i t e n d e r a
bannaabwe	b a n n a a b w e
ky’abantu	k y ’ a b a n t u
baalina	b a a l i n a
obuyigirize	o b u y i g i r i z e
kulwanyisa	k u l w a n y i s a
beenyigira	b e e n y i g i r a
abangi	a b a n g i
kyaddondo	k y a d d o n d o
ezenjawulo	e z e n j a w u l o
otegeera	o t e g e e r a
bifo	b i f o
bamakanika	b a m a k a n i k a
ebizibu	e b i z i b u
tugenda	t u g e n d a
babonyaaboonya	b a b o n y a a b o o n y a
kuliteeka	k u l i t e e k a
n’ebakitaputira	n ’ e b a k i t a p u t i r a
bazannyira	b a z a n n y i r a
mukiibi	m u k i i b i
okuleeterea	o k u l e e t e r e a
kawempe	k a w e m p e
badru	b a d r u
obulindaala	o b u l i n d a a l a
kitundu	k i t u n d u
omwezi	o m w e z i
ttooyi	t t o o y i
zino	z i n o
kussuuka	k u s s u u k a
olwokuba	o l w o k u b a
amakanisa	a m a k a n i s a
abava	a b a v a
olina	o l i n a
tubeebaza	t u b e e b a z a
atukubiriza	a t u k u b i r i z a
weggwanga	w e g g w a n g a
yanjulwa	y a n j u l w a
okutekamu	o k u t e k a m u
abavubuka	a b a v u b u k a
wange	w a n g e
beebikka	b e e b i k k a
weddira	w e d d i r a
kasinga	k a s i n g a
mpulira	m p u l i r a
babadde	b a b a d d e
omu	o m u
leero	l e e r o
muntu	m u n t u
bwetaaga	b w e t a a g a
kalina	k a l i n a
nedda	n e d d a
abawagizi	a b a w a g i z i
bano	b a n o
esatu	e s a t u
kikula	k i k u l a
lubuto	l u b u t o
waggonjebwa	w a g g o n j e b w a
lwomwana	l w o m w a n a
muwendo	m u w e n d o
kusasula	k u s a s u l a
yalondeddwa	y a l o n d e d d w a
kittabantu	k i t t a b a n t u
tugatte	t u g a t t e
gyonna	g y o n n a
kyoyagala	k y o y a g a l a
omunnyo	o m u n n y o
baggala	b a g g a l a
okuzimbibwa	o k u z i m b i b w a
kuweereza	k u w e e r e z a
ente	e n t e
ennyange	e n n y a n g e
ezikola	e z i k o l a
boobubudamu	b o o b u b u d a m u
bansasula	b a n s a s u l a
waleme	w a l e m e
njuba	n j u b a
okutaasa	o k u t a a s a
tewaaliwo	t e w a a l i w o
baalumiziddwa	b a a l u m i z i d d w a
okwerabira	o k w e r a b i r a
zokwawukana	z o k w a w u k a n a
okutondawo	o k u t o n d a w o
kansala	k a n s a l a
abayimbi	a b a y i m b i
eziviiriddeko	e z i v i i r i d d e k o
olugero	o l u g e r o
omuddo	o m u d d o
yakubibwa	y a k u b i b w a
ebitafuna	e b i t a f u n a
etadde	e t a d d e
basanga	b a s a n g a
tennaba	t e n n a b a
bwabyo	b w a b y o
obuyonjo	o b u y o n j o
abakalamojja	a b a k a l a m o j j a
nabantu	n a b a n t u
okunyigirizibwa	o k u n y i g i r i z i b w a
buvudde	b u v u d d e
baagaanira	b a a g a a n i r a
nkukubira	n k u k u b i r a
omwami	o m w a m i
eyanjudde	e y a n j u d d e
gutuuka	g u t u u k a
lukiiko	l u k i i k o
ajja	a j j a
okutangira	o k u t a n g i r a
newankubadde	n e w a n k u b a d d e
bwaweza	b w a w e z a
beesabikira	b e e s a b i k i r a
zomukago	z o m u k a g o
olwaleero	o l w a l e e r o
akabi	a k a b i
oddemu	o d d e m u
beenyigire	b e e n y i g i r e
kibiinja	k i b i i n j a
empologoma	e m p o l o g o m a
ababadde	a b a b a d d e
nnannyini	n n a n n y i n i
beesigwa	b e e s i g w a
town	t o w n
baawangula	b a a w a n g u l a
ki	k i
nobubbi	n o b u b b i
ebisolo	e b i s o l o
ebinazi	e b i n a z i
lukumi	l u k u m i
okumpuliriza	o k u m p u l i r i z a
kitundu	k i t u n d u
gebyensoma	g e b y e n s o m a
ngumu	n g u m u
ettaka	e t t a k a
nkiiko	n k i i k o
katongole	k a t o n g o l e
okulangibwa	o k u l a n g i b w a
baalya	b a a l y a
abakwetoolodde	a b a k w e t o o l o d d e
bba	b b a
gwomuntu	g w o m u n t u
lwokubiri	l w o k u b i r i
obuka	o b u k a
okutyoboola	o k u t y o b o o l a
ekiyiiye	e k i y i i y e
ensolo	e n s o l o
egamba	e g a m b a
mingi	m i n g i
obwakabaka	o b w a k a b a k a
mpandiika	m p a n d i i k a
kuwa	k u w a
etuuse	e t u u s e
bafune	b a f u n e
kikulu	k i k u l u
erigenda	e r i g e n d a
okujulira	o k u j u l i r a
abaatoloka	a b a a t o l o k a
nnyumba	n n y u m b a
aboogera	a b o o g e r a
okulabiriranga	o k u l a b i r i r a n g a
mmubuuliremu	m m u b u u l i r e m u
esinga	e s i n g a
basasulwa	b a s a s u l w a
egiwulirwa	e g i w u l i r w a
omusolo	o m u s o l o
okulima	o k u l i m a
kivunaanyibwa	k i v u n a a n y i b w a
n’engeri	n ’ e n g e r i
abeesimbyewo	a b e e s i m b y e w o
makomera	m a k o m e r a
lye	l y e
bakutte	b a k u t t e
ge	g e
bwoku	b w o k u
nalubaale	n a l u b a a l e
buyita	b u y i t a
mungi	m u n g i
lunaku	l u n a k u
byabantu	b y a b a n t u
enkwata	e n k w a t a
ne	n e
basimbye	b a s i m b y e
yakomangawo	y a k o m a n g a w o
olwebintu	o l w e b i n t u
bijjidde	b i j j i d d e
ataddemu	a t a d d e m u
kulabagana	k u l a b a g a n a
nineteen	n i n e t e e n
mawokota	m a w o k o t a
kubeerayo	k u b e e r a y o
twetaaga	t w e t a a g a
gyekibiina	g y e k i b i i n a
essanyu	e s s a n y u
ekitabo	e k i t a b o
ebbeeyi	e b b e e y i
lya	l y a
mmayiro	m m a y i r o
oyinza	o y i n z a
akulira	a k u l i r a
bibala	b i b a l a
ze	z e
baava	b a a v a
ezo	e z o
egiwera	e g i w e r a
baasabibwa	b a a s a b i b w a
balamu	b a l a m u
ntege	n t e g e
y’ekitontome	y ’ e k i t o n t o m e
eddiini	e d d i i n i
ogwokuva	o g w o k u v a
tebasaanidde	t e b a s a a n i d d e
nategeeza	n a t e g e e z a
gw’olulimi	g w ’ o l u l i m i
erabika	e r a b i k a
gwomukwano	g w o m u k w a n o
birina	b i r i n a
okugaziwa	o k u g a z i w a
ofunamu	o f u n a m u
yayagalana	y a y a g a l a n a
okubaawo	o k u b a a w o
omutimbagano	o m u t i m b a g a n o
omugaso	o m u g a s o
oguwedde	o g u w e d d e
gava	g a v a
omwerufu	o m w e r u f u
cross	c r o s s
mu	m u
yakulira	y a k u l i r a
bagenda	b a g e n d a
endokwa	e n d o k w a
okutandikawo	o k u t a n d i k a w o
ekikubo	e k i k u b o
ng’abantu	n g ’ a b a n t u
munda	m u n d a
etundibwa	e t u n d i b w a
nkola	n k o l a
omusirikale	o m u s i r i k a l e
ezitukula	e z i t u k u l a
abapya	a b a p y a
weetegeke	w e e t e g e k e
muleese	m u l e e s e
okuteekerateekera	o k u t e e k e r a t e e k e r a
gaffe	g a f f e
nema	n e m a
mwakubidde	m w a k u b i d d e
mikwano	m i k w a n o
toyomba	t o y o m b a
waka	w a k a
bakazi	b a k a z i
kugenda	k u g e n d a
tekyawulayawula	t e k y a w u l a y a w u l a
kukusasula	k u k u s a s u l a
abatamanyiddwa	a b a t a m a n y i d d w a
unity	u n i t y
obadde	o b a d d e
nabyo	n a b y o
bikozesebwa	b i k o z e s e b w a
batuwadde	b a t u w a d d e
bwange	b w a n g e
entandikwa	e n t a n d i k w a
zokka	z o k k a
ttiimu	t t i i m u
ekitongole	e k i t o n g o l e
omuserikale	o m u s e r i k a l e
gya	g y a
okukeberebwa	o k u k e b e r e b w a
birungi	b i r u n g i
ng’amanyi	n g ’ a m a n y i
eyita	e y i t a
amaloboozi	a m a l o b o o z i
ekyo	e k y o
agawera	a g a w e r a
mulimu	m u l i m u
kuvumirira	k u v u m i r i r a
kyennyonyi	k y e n n y o n y i
ssowani	s s o w a n i
kitumbula	k i t u m b u l a
kaseera	k a s e e r a
kuwaayo	k u w a a y o
ekiku	e k i k u
matono	m a t o n o
ngayunga	n g a y u n g a
beefuulira	b e e f u u l i r a
oyo	o y o
yensonga	y e n s o n g a
ajagujagu	a j a g u j a g u
kwetabiddwako	k w e t a b i d d w a k o
alina	a l i n a
bazimbye	b a z i m b y e
zisobola	z i s o b o l a
kikulu	k i k u l u
bassenga	b a s s e n g a
bandikwatiddwa	b a n d i k w a t i d d w a
ebivuga	e b i v u g a
nobutabanguko	n o b u t a b a n g u k o
bbaluti	b b a l u t i
kabona	k a b o n a
omuceere	o m u c e e r e
okufulumya	o k u f u l u m y a
zebweru	z e b w e r u
balinze	b a l i n z e
baffe	b a f f e
baakubirizza	b a a k u b i r i z z a
bijja	b i j j a
ezebyobulamu	e z e b y o b u l a m u
abazzi	a b a z z i
alipoota	a l i p o o t a
okukkiriziganya	o k u k k i r i z i g a n y a
namazzi	n a m a z z i
ekitiibwa	e k i t i i b w a
olumu	o l u m u
mukenenya	m u k e n e n y a
okufaananako	o k u f a a n a n a k o
okwenyigiramu	o k w e n y i g i r a m u
ebya	e b y a
kunoonyereza	k u n o o n y e r e z a
beesigwa	b e e s i g w a
obakyala	o b a k y a l a
obuyaaye	o b u y a a y e
eyagala	e y a g a l a
abasenga	a b a s e n g a
buli	b u l i
amakakali	a m a k a k a l i
baagamba	b a a g a m b a
bulange	b u l a n g e
atabisomye	a t a b i s o m y e
engenderere	e n g e n d e r e r e
egivaamu	e g i v a a m u
entebe	e n t e b e
baki	b a k i
alabudde	a l a b u d d e
abayagaliza	a b a y a g a l i z a
kifuba	k i f u b a
obuwangwa	o b u w a n g w a
bawandiika	b a w a n d i i k a
abaddugavu	a b a d d u g a v u
makoola	m a k o o l a
babbiddewo	b a b b i d d e w o
abayiiya	a b a y i i y a
okutuuka	o k u t u u k a
tebannasasulwa	t e b a n n a s a s u l w a
	
esabye	e s a b y e
mirembe	m i r e m b e
olwokufaayo	o l w o k u f a a y o
banoonyerereza	b a n o o n y e r e r e z a
eziri	e z i r i
beefula	b e e f u l a
miwendo	m i w e n d o
ekisoose	e k i s o o s e
enjala	e n j a l a
bunyuma	b u n y u m a
empale	e m p a l e
bwammwe	b w a m m w e
wonna	w o n n a
asasula	a s a s u l a
okubaka	o k u b a k a
ekiviirako	e k i v i i r a k o
nokubudaabuda	n o k u b u d a a b u d a
okwogiwaza	o k w o g i w a z a
bakusobera	b a k u s o b e r a
bbaasi	b b a a s i
kubeera	k u b e e r a
emugga	e m u g g a
walina	w a l i n a
wange	w a n g e
gwatwalibwa	g w a t w a l i b w a
batwalirizibwa	b a t w a l i r i z i b w a
niddwa	n i d d w a
yaakamala	y a a k a m a l a
mubala	m u b a l a
katale	k a t a l e
bafudde	b a f u d d e
bazimanyiimu	b a z i m a n y i i m u
kizibwe	k i z i b w e
byamazzi	b y a m a z z i
luno	l u n o
zamazzi	z a m a z z i
babuuzizza	b a b u u z i z z a
nnamuwendo	n n a m u w e n d o
gaalemererwa	g a a l e m e r e r w a
ekyebitaano	e k y e b i t a a n o
gaggyibwa	g a g g y i b w a
akakookolo	a k a k o o k o l o
enkaajumbe	e n k a a j u m b e
n’ebigezo	n ’ e b i g e z o
wajjawo	w a j j a w o
yeddira	y e d d i r a
lyessanyu	l y e s s a n y u
bategekeddwa	b a t e g e k e d d w a
balemereddwa	b a l e m e r e d d w a
asubwa	a s u b w a
baawukane	b a a w u k a n e
neetaga	n e e t a g a
obwoka	o b w o k a
kukungaaanyizibwa	k u k u n g a a a n y i z i b w a
ayitiwo	a y i t i w o
ezokunkya’	e z o k u n k y a ’
nagwo	n a g w o
omwoyo	o m w o y o
aboludda	a b o l u d d a
emmwanyi	e m m w a n y i
batwala	b a t w a l a
akoze	a k o z e
gw’abaana	g w ’ a b a a n a
namayiba	n a m a y i b a
lukya	l u k y a
ebyobugagga	e b y o b u g a g g a
gyendi	g y e n d i
ekikoze	e k i k o z e
byabasawo	b y a b a s a w o
abamuddako	a b a m u d d a k o
litambula	l i t a m b u l a
basembeza	b a s e m b e z a
odoi	o d o i
yakanga	y a k a n g a
mwogezi	m w o g e z i
amakufulu	a m a k u f u l u
budde	b u d d e
abiri	a b i r i
galemesezza	g a l e m e s e z z a
b’osobola	b ’ o s o b o l a
babiri	b a b i r i
tebafaayo	t e b a f a a y o
atawanyizibwa	a t a w a n y i z i b w a
essimu	e s s i m u
obwama	o b w a m a
mukuba	m u k u b a
ebyobutujju	e b y o b u t u j j u
abataagala	a b a t a a g a l a
batwale	b a t w a l e
womwenkanonkano	w o m w e n k a n o n k a n o
ebitundu	e b i t u n d u
bwe	b w e
byobulimi	b y o b u l i m i
ogenda	o g e n d a
ebipya	e b i p y a
national	n a t i o n a l
nokugatta	n o k u g a t t a
mpagira	m p a g i r a
oteeka	o t e e k a
mawanga	m a w a n g a
bimuzza	b i m u z z a
kyokuzina	k y o k u z i n a
guviiriddeko	g u v i i r i d d e k o
tebaagatibwa	t e b a a g a t i b w a
linnyonnyolwa	l i n n y o n n y o l w a
ababbi	a b a b b i
kkanisa	k k a n i s a
kimugwanira	k i m u g w a n i r a
wakwekebeza	w a k w e k e b e z a
bateekebwa	b a t e e k e b w a
mpale	m p a l e
egaanye	e g a a n y e
abasinga	a b a s i n g a
baweebwa	b a w e e b w a
birowoozo	b i r o w o o z o
aba	a b a
ogwokubiri	o g w o k u b i r i
kuyingiza	k u y i n g i z a
amaavu	a m a a v u
abasaakirirza	a b a s a a k i r i r z a
akyattunka	a k y a t t u n k a
obukookolo	o b u k o o k o l o
mungi	m u n g i
gimanyisa	g i m a n y i s a
eyakoze	e y a k o z e
oluvuganya	o l u v u g a n y a
omunaana	o m u n a a n a
byensi	b y e n s i
gyemiyembe	g y e m i y e m b e
olwabakozi	o l w a b a k o z i
kiwambabantu	k i w a m b a b a n t u
kkooti	k k o o t i
ngabantu	n g a b a n t u
kwonoona	k w o n o o n a
obuyinza	o b u y i n z a
gomusaayi	g o m u s a a y i
nekizimbe	n e k i z i m b e
etteeka	e t t e e k a
eziyinza	e z i y i n z a
ky’	k y ’
buna	b u n a
kibuga	k i b u g a
kyenda	k y e n d a
mugwoze	m u g w o z e
abafera	a b a f e r a
bakubiriza	b a k u b i r i z a
amalirize	a m a l i r i z e
nokutta	n o k u t t a
magombolola	m a g o m b o l o l a
baali	b a a l i
bbo	b b o
kampuni	k a m p u n i
abebyobulamu	a b e b y o b u l a m u
namirembe	n a m i r e m b e
okubaga	o k u b a g a
okukkiririza	o k u k k i r i r i z a
tayagala	t a y a g a l a
gufuuse	g u f u u s e
okusala	o k u s a l a
nduli	n d u l i
nkoko	n k o k o
katikkiro	k a t i k k i r o
eggulo	e g g u l o
abaserikale	a b a s e r i k a l e
kyokka	k y o k k a
eddagala	e d d a g a l a
okuyingiza	o k u y i n g i z a
makya	m a k y a
nasaba	n a s a b a
booda	b o o d a
gyeri	g y e r i
manafu	m a n a f u
okwekalakaasa	o k w e k a l a k a a s a
kaakukendeeza	k a a k u k e n d e e z a
obwavu	o b w a v u
okulimira	o k u l i m i r a
omwenyi	o m w e n y i
kumanya	k u m a n y a
zembaga	z e m b a g a
ennyonyi	e n n y o n y i
yasaaliza	y a s a a l i z a
baagaanye	b a a g a a n y e
kaakazuulamu	k a a k a z u u l a m u
yamusaba	y a m u s a b a
kiseera	k i s e e r a
kwebiri	k w e b i r i
bakolaganira	b a k o l a g a n i r a
bamagye	b a m a g y e
kulitutwakako	k u l i t u t w a k a k o
gyawaka	g y a w a k a
kugobako	k u g o b a k o
nekyeggulo	n e k y e g g u l o
okutwalira	o k u t w a l i r a
womukulu	w o m u k u l u
ntenvu	n t e n v u
bwali	b w a l i
bebirowoozo	b e b i r o w o o z o
nengoye	n e n g o y e
abalenzi	a b a l e n z i
yokuzimba	y o k u z i m b a
kitubala	k i t u b a l a
omusango	o m u s a n g o
kukendeeza	k u k e n d e e z a
maaso	m a a s o
awe	a w e
namugamba	n a m u g a m b a
yokubudaabuda	y o k u b u d a a b u d a
kwolwo	k w o l w o
emisango	e m i s a n g o
gujja	g u j j a
mbidde	m b i d d e
kusooka	k u s o o k a
gwe	g w e
embavu	e m b a v u
kovidi	k o v i d i
obutakwatagana	o b u t a k w a t a g a n a
bwegugungo	b w e g u g u n g o
terefayina	t e r e f a y i n a
okwekuuma	o k w e k u u m a
bunaggya	b u n a g g y a
buyamba	b u y a m b a
enneeyisa	e n n e e y i s a
okubangula	o k u b a n g u l a
namugongo	n a m u g o n g o
zonna	z o n n a
gwalaga	g w a l a g a
bwabadde	b w a b a d d e
abamenyi	a b a m e n y i
society	s o c i e t y
okulunda	o k u l u n d a
gabantu	g a b a n t u
byomujjuzo	b y o m u j j u z o
akatale	a k a t a l e
engassi	e n g a s s i
kundagirirako	k u n d a g i r i r a k o
nnyonnyola	n n y o n n y o l a
ennyimba	e n n y i m b a
n’addirirwa	n ’ a d d i r i r w a
nnina	n n i n a
mwetowaze	m w e t o w a z e
ennimi	e n n i m i
omusujja	o m u s u j j a
okuwandiika	o k u w a n d i i k a
okutegekebwa	o k u t e g e k e b w a
kusala	k u s a l a
kasasiro	k a s a s i r o
bataataaganya	b a t a a t a a g a n y a
ngomumuli	n g o m u m u l i
amagye	a m a g y e
abeesenzezza	a b e e s e n z e z z a
lwamazaalibwa	l w a m a z a a l i b w a
laga	l a g a
abaganda	a b a g a n d a
bafunye	b a f u n y e
nzira	n z i r a
abakulu	a b a k u l u
ng’ekimu	n g ’ e k i m u
eyo	e y o
batuula	b a t u u l a
kyettaka	k y e t t a k a
institute	i n s t i t u t e
bayinza	b a y i n z a
byobugagga	b y o b u g a g g a
okusemberera	o k u s e m b e r e r a
ssaako	s s a a k o
ebirungo	e b i r u n g o
kuyita	k u y i t a
nteekateeka	n t e e k a t e e k a
yategeeza	y a t e g e e z a
ewa	e w a
ewaabwe	e w a a b w e
nebifo	n e b i f o
nokunoonya	n o k u n o o n y a
obujjanjabi	o b u j j a n j a b i
okusomera	o k u s o m e r a
okola	o k o l a
butuyambye	b u t u y a m b y e
baasenguka	b a a s e n g u k a
abakulu	a b a k u l u
kwakawuka	k w a k a w u k a
entalo	e n t a l o
obufumbo	o b u f u m b o
batya	b a t y a
bulungi	b u l u n g i
okujja	o k u j j a
gonna	g o n n a
ssentongo	s s e n t o n g o
bintu	b i n t u
ekiwambabantu	e k i w a m b a b a n t u
ebizimbe	e b i z i m b e
adde	a d d e
liyise	l i y i s e
basaakiriza	b a s a a k i r i z a
b’e	b ’ e
okulowooza	o k u l o w o o z a
kumi	k u m i
manvuuli	m a n v u u l i
0	0
kisaanidde	k i s a a n i d d e
eby’ekibiina	e b y ’ e k i b i i n a
zandikendeezezza	z a n d i k e n d e e z e z z a
ayinza	a y i n z a
entaana	e n t a a n a
gy’abantu	g y ’ a b a n t u
akubiriza	a k u b i r i z a
olugezigezi	o l u g e z i g e z i
sirikanga	s i r i k a n g a
akaddukanya	a k a d d u k a n y a
musaala	m u s a a l a
nobutebenkevu	n o b u t e b e n k e v u
ekiwugirwamu	e k i w u g i r w a m u
yatandika	y a t a n d i k a
okwetaba	o k w e t a b a
lulimi	l u l i m i
mukama	m u k a m a
okweyisiza	o k w e y i s i z a
eziyingira	e z i y i n g i r a
keegugungo	k e e g u g u n g o
okusaanyaawo	o k u s a a n y a a w o
omubi	o m u b i
yamulaba	y a m u l a b a
kwewala	k w e w a l a
enkungaana	e n k u n g a a n a
matendekero	m a t e n d e k e r o
atya	a t y a
okusenguka	o k u s e n g u k a
zokusasula	z o k u s a s u l a
law	l a w
esomerwamu	e s o m e r w a m u
kuziba	k u z i b a
kikyagenda	k i k y a g e n d a
agenda	a g e n d a
banyooma	b a n y o o m a
bunkenke	b u n k e n k e
n’embiro	n ’ e m b i r o
baabanga	b a a b a n g a
abaabadde	a b a a b a d d e
disitulikiti	d i s i t u l i k i t i
obumu	o b u m u
etya	e t y a
byalimu	b y a l i m u
ekigatta	e k i g a t t a
okuggyako	o k u g g y a k o
nakoma	n a k o m a
kabaka	k a b a k a
ssimu	s s i m u
by’okuzaala	b y ’ o k u z a a l a
ziyambye	z i y a m b y e
ebisinga	e b i s i n g a
kino	k i n o
byuma	b y u m a
ebbanga	e b b a n g a
kkubo	k k u b o
kitaasizza	k i t a a s i z z a
ndya	n d y a
egyenjawulo	e g y e n j a w u l o
njigiriza	n j i g i r i z a
omukambwe	o m u k a m b w e
ekya	e k y a
bakujjanjabira	b a k u j j a n j a b i r a
yembeera	y e m b e e r a
abawere	a b a w e r e
ngengeri	n g e n g e r i
tubeera	t u b e e r a
baguzibwa	b a g u z i b w a
okwegatta	o k w e g a t t a
ennyama	e n n y a m a
kye	k y e
tegwandibadde	t e g w a n d i b a d d e
tegeka	t e g e k a
b’ogenda	b ’ o g e n d a
kiva	k i v a
lyabantu	l y a b a n t u
beeweze	b e e w e z e
n’amannya	n ’ a m a n n y a
bamukebera	b a m u k e b e r a
babiri	b a b i r i
yategeezezza	y a t e g e e z e z z a
olwobutaba	o l w o b u t a b a
okuyambibwako	o k u y a m b i b w a k o
biroole	b i r o o l e
basoma	b a s o m a
mugoberera	m u g o b e r e r a
neeyisa	n e e y i s a
bayanirizibwa	b a y a n i r i z i b w a
kukozesaawo	k u k o z e s a a w o
akaseera	a k a s e e r a
bayina	b a y i n a
gabalimi	g a b a l i m i
lwenkulaakulana	l w e n k u l a a k u l a n a
gyabantu	g y a b a n t u
okwekulaakulanya	o k w e k u l a a k u l a n y a
yagenda	y a g e n d a
eggye	e g g y e
beebaza	b e e b a z a
awali	a w a l i
bifulumizibwa	b i f u l u m i z i b w a
okuyigiriza	o k u y i g i r i z a
katumba	k a t u m b a
zempapula	z e m p a p u l a
omugenzi	o m u g e n z i
nobwesige	n o b w e s i g e
galimu	g a l i m u
kwokufuna	k w o k u f u n a
bava	b a v a
okudda	o k u d d a
ekirabo	e k i r a b o
ejjudde	e j j u d d e
lwange	l w a n g e
mwebale	m w e b a l e
okugaana	o k u g a a n a
yakola	y a k o l a
buduuda	b u d u u d a
bakeera	b a k e e r a
nazo	n a z o
gyamawulire	g y a m a w u l i r e
omunaanaansi	o m u n a a n a a n s i
yatukubirizza	y a t u k u b i r i z z a
byabwe	b y a b w e
ng’omwana	n g ’ o m w a n a
batambula	b a t a m b u l a
bwensi	b w e n s i
abalwadde	a b a l w a d d e
olukyasinze	o l u k y a s i n z e
zigenda	z i g e n d a
obwerufu	o b w e r u f u
mangu	m a n g u
omuzannyo	o m u z a n n y o
ba	b a
eyogeza	e y o g e z a
kulambula	k u l a m b u l a
ke	k e
mufumbo	m u f u m b o
wekinnansi	w e k i n n a n s i
bagudde	b a g u d d e
kubaawo	k u b a a w o
agiwulira	a g i w u l i r a
ebyensimbi	e b y e n s i m b i
baagenti	b a a g e n t i
ekkulu	e k k u l u
olumbe	o l u m b e
kikolwa	k i k o l w a
mwenda	m w e n d a
beereetera	b e e r e e t e r a
nattidde	n a t t i d d e
muteesa	m u t e e s a
ebibabudamya	e b i b a b u d a m y a
bwamala	b w a m a l a
emitendera	e m i t e n d e r a
mwe	m w e
tumenyereyo	t u m e n y e r e y o
bw	b w
nzijanjaba	n z i j a n j a b a
asobola	a s o b o l a
eyambyeko	e y a m b y e k o
endya	e n d y a
bika	b i k a
amaka	a m a k a
kwe	k w e
kisenyi	k i s e n y i
akalaga	a k a l a g a
yavumbagira	y a v u m b a g i r a
buyitirivu	b u y i t i r i v u
likaawa	l i k a a w a
bisobola	b i s o b o l a
okwagalibwa	o k w a g a l i b w a
annyonnyodde	a n n y o n n y o d d e
namaterekero	n a m a t e r e k e r o
ebyokuzimba	e b y o k u z i m b a
okimanyi	o k i m a n y i
gaabwe	g a a b w e
ekingi	e k i n g i
okufuna	o k u f u n a
abuuza	a b u u z a
yitira	y i t i r a
omanya	o m a n y a
gwabwe	g w a b w e
kutuula	k u t u u l a
bitwala	b i t w a l a
osanga	o s a n g a
ebyafaayo	e b y a f a a y o
mirundi	m i r u n d i
gwokukuuma	g w o k u k u u m a
enkumi	e n k u m i
obuwagizi	o b u w a g i z i
amabeere	a m a b e e r e
bayita	b a y i t a
emiti	e m i t i
abatwalira	a b a t w a l i r a
kubakambuwalira	k u b a k a m b u w a l i r a
nakasi	n a k a s i
	
engoye	e n g o y e
ki	k i
musango	m u s a n g o
okweyisa	o k w e y i s a
nemicungwa	n e m i c u n g w a
ebirango	e b i r a n g o
munnange	m u n n a n g e
kuno	k u n o
mwaka	m w a k a
ateberezebwa	a t e b e r e z e b w a
ebitooke	e b i t o o k e
ye	y e
amagoba	a m a g o b a
mayumba	m a y u m b a
omulimu	o m u l i m u
okubifunamu	o k u b i f u n a m u
tolina	t o l i n a
byabwe	b y a b w e
baawadde	b a a w a d d e
endala	e n d a l a
okukomyawo	o k u k o m y a w o
gyetuyinza	g y e t u y i n z a
katonda	k a t o n d a
ekimu	e k i m u
egikulaakulanya	e g i k u l a a k u l a n y a
olwaliyo	o l w a l i y o
okutuusibwa	o k u t u u s i b w a
babanyagako	b a b a n y a g a k o
nebyokukola	n e b y o k u k o l a
gennaku	g e n n a k u
kuyamba	k u y a m b a
kutandika	k u t a n d i k a
okwewalibwa	o k w e w a l i b w a
enkulu	e n k u l u
eyagazizza	e y a g a z i z z a
sijjukira	s i j j u k i r a
okubbibwako	o k u b b i b w a k o
asabye	a s a b y e
unesco	u n e s c o
abalongoosa	a b a l o n g o o s a
ssennyiga	s s e n n y i g a
balwalanga	b a l w a l a n g a
natuula	n a t u u l a
teyita	t e y i t a
nsi	n s i
ebitusomooza	e b i t u s o m o o z a
kimuleetera	k i m u l e e t e r a
omwegendereza	o m w e g e n d e r e z a
abanoonyiboobubuddamu	a b a n o o n y i b o o b u b u d d a m u
yebyobulamu	y e b y o b u l a m u
baweereddwa	b a w e e r e d d w a
abaakiwandiika	a b a a k i w a n d i i k a
ozikozese	o z i k o z e s e
obululu	o b u l u l u
byo	b y o
ebyokukozesa	e b y o k u k o z e s a
ebikuumaddembe	e b i k u u m a d d e m b e
ekipande	e k i p a n d e
ebiva	e b i v a
ebyenkizo	e b y e n k i z o
bekinnansi	b e k i n n a n s i
bagoberera	b a g o b e r e r a
obuvaamu	o b u v a a m u
nokutiisibwatiisibwa	n o k u t i i s i b w a t i i s i b w a
abaabulwako	a b a a b u l w a k o
banaabwe	b a n a a b w e
mpereza	m p e r e z a
ebigasiza	e b i g a s i z a
yabuulirira	y a b u u l i r i r a
abasalawo	a b a s a l a w o
gaabwe	g a a b w e
mubi	m u b i
bulamu	b u l a m u
obulungi	o b u l u n g i
okwogiwazibwa	o k w o g i w a z i b w a
yansanyusa	y a n s a n y u s a
omuto	o m u t o
laadiyo	l a a d i y o
olukangaga	o l u k a n g a g a
buwambe	b u w a m b e
ggwanga	g g w a n g a
amafumbe	a m a f u m b e
bwekuluma	b w e k u l u m a
bamutuma	b a m u t u m a
kw’otadde	k w ’ o t a d d e
bwesigwa	b w e s i g w a
wabeerewo	w a b e e r e w o
okwewandiisa	o k w e w a n d i i s a
tukyayogera	t u k y a y o g e r a
kati	k a t i
ngosika	n g o s i k a
waakukkirizibwayo	w a a k u k k i r i z i b w a y o
yokwewalamu	y o k w e w a l a m u
abafere	a b a f e r e
byobutonde	b y o b u t o n d e
okuswala	o k u s w a l a
obuyinike	o b u y i n i k e
tebaziwa	t e b a z i w a
nokukozesa	n o k u k o z e s a
obuyambi	o b u y a m b i
abaasoma	a b a a s o m a
ewaka	e w a k a
baagala	b a a g a l a
kisaganda	k i s a g a n d a
ekinyuma	e k i n y u m a
ebizimba	e b i z i m b a
nzirugavu	n z i r u g a v u
byekitundu	b y e k i t u n d u
omukambwe	o m u k a m b w e
siriimu	s i r i i m u
ayambala	a y a m b a l a
koonoona	k o o n o o n a
kisusse	k i s u s s e
maka	m a k a
ebyobuwangwa	e b y o b u w a n g w a
agamba	a g a m b a
magoba	m a g o b a
basingisibwa	b a s i n g i s i b w a
b”ekibiina	b ” e k i b i i n a
luwummula	l u w u m m u l a
nsuubira	n s u u b i r a
omuzadde	o m u z a d d e
abasabye	a b a s a b y e
n’amaka	n ’ a m a k a
abazadde	a b a z a d d e
balagiddwa	b a l a g i d d w a
okwerinda	o k w e r i n d a
esuubira	e s u u b i r a
ntambula	n t a m b u l a
bakungaanya	b a k u n g a a n y a
wadde	w a d d e
avunaanyizibwa	a v u n a a n y i z i b w a
wenjiri	w e n j i r i
omuli	o m u l i
yayita	y a y i t a
babbye	b a b b y e
mbeera	m b e e r a
abeesimbyewo	a b e e s i m b y e w o
mayiga	m a y i g a
zo	z o
egobe	e g o b e
kkumi	k k u m i
osikire	o s i k i r e
ngenda	n g e n d a
moyo	m o y o
bukadde	b u k a d d e
byomuggalo	b y o m u g g a l o
naye	n a y e
kirwadde	k i r w a d d e
abalimi	a b a l i m i
tebambadde	t e b a m b a d d e
abalondemu	a b a l o n d e m u
katagaza	k a t a g a z a
omuntu	o m u n t u
kubanguyiza	k u b a n g u y i z a
tutandika	t u t a n d i k a
nabasajja	n a b a s a j j a
abasomi	a b a s o m i
mulembe	m u l e m b e
lye	l y e
yonna	y o n n a
kukwatibwa	k u k w a t i b w a
ameekusifu	a m e e k u s i f u
olwokuba	o l w o k u b a
amagezi	a m a g e z i
kaseera	k a s e e r a
kaboggoza	k a b o g g o z a
eno	e n o
kutambula	k u t a m b u l a
nebaka	n e b a k a
busobozi	b u s o b o z i
okuba	o k u b a
yazaalibwa	y a z a a l i b w a
okumumanyisa	o k u m u m a n y i s a
ezeetagisa	e z e e t a g i s a
nokwenyigira	n o k w e n y i g i r a
okwogera	o k w o g e r a
yeeyongera	y e e y o n g e r a
yakaksa	y a k a k s a
batereezezza	b a t e r e e z e z z a
kkojja	k k o j j a
oluwanvu	o l u w a n v u
machine	m a c h i n e
mbwa	m b w a
yobukaba	y o b u k a b a
abatusemba	a b a t u s e m b a
emigumu	e m i g u m u
mikutu	m i k u t u
amayinja	a m a y i n j a
piki	p i k i
wansi	w a n s i
kasirye	k a s i r y e
ebyemizannyo	e b y e m i z a n n y o
mwenna	m w e n n a
ebigezo	e b i g e z o
omumyuka	o m u m y u k a
ensonga	e n s o n g a
kukozesa	k u k o z e s a
beetegefu	b e e t e g e f u
ettima	e t t i m a
alyoke	a l y o k e
empisa	e m p i s a
bulumye	b u l u m y e
gw’ozaaala	g w ’ o z a a a l a
okukyuka	o k u k y u k a
babakozesebwa	b a b a k o z e s e b w a
binaava	b i n a a v a
bennyimba	b e n n y i m b a
abakugu	a b a k u g u
okukolera	o k u k o l e r a
endala	e n d a l a
buziba	b u z i b a
bwolaba	b w o l a b a
okwetooloola	o k w e t o o l o o l a
eriyiseeko	e r i y i s e e k o
baagambiddwa	b a a g a m b i d d w a
okweyimirirwa	o k w e y i m i r i r w a
zaalagiddwa	z a a l a g i d d w a
kuggwaamu	k u g g w a a m u
bafuddeyo	b a f u d d e y o
enkiiko	e n k i i k o
ebyenjawulo	e b y e n j a w u l o
embwa	e m b w a
musango	m u s a n g o
gwembeera	g w e m b e e r a
bulamu	b u l a m u
gw’abakazi	g w ’ a b a k a z i
nneeraliikirizza	n n e e r a l i i k i r i z z a
mwesimbu	m w e s i m b u
akulidde	a k u l i d d e
kyokukola	k y o k u k o l a
abakurisito	a b a k u r i s i t o
gyabwe	g y a b w e
kulinda	k u l i n d a
siyinza	s i y i n z a
abatayagala	a b a t a y a g a l a
mwogenda	m w o g e n d a
ebajja	e b a j j a
kkanisa	k k a n i s a
ngoyogera	n g o y o g e r a
akakira	a k a k i r a
ffaamu	f f a a m u
tebyawera	t e b y a w e r a
nyingi	n y i n g i
mwanamugimu	m w a n a m u g i m u
bukakata	b u k a k a t a
okukolaganira	o k u k o l a g a n i r a
namusobyako	n a m u s o b y a k o
ssekinnoomu	s s e k i n n o o m u
bebitongole	b e b i t o n g o l e
abaasibwa	a b a a s i b w a
zaawerebwa	z a a w e r e b w a
ennyo	e n n y o
ebyaweebwa	e b y a w e e b w a
emiti	e m i t i
okusembera	o k u s e m b e r a
ebifo	e b i f o
namuli	n a m u l i
ly’abantu	l y ’ a b a n t u
kutwala	k u t w a l a
kawungeezi	k a w u n g e e z i
kupapa	k u p a p a
okugoberera	o k u g o b e r e r a
omuganda	o m u g a n d a
yaffe	y a f f e
wakoze	w a k o z e
womukulembeze	w o m u k u l e m b e z e
abawala	a b a w a l a
asomesezza	a s o m e s e z z a
wiiki	w i i k i
bikakali	b i k a k a l i
nsanikiddwa	n s a n i k i d d w a
obuzibu	o b u z i b u
yokuweereza	y o k u w e e r e z a
yasaba	y a s a b a
nakawangula	n a k a w a n g u l a
bazitereka	b a z i t e r e k a
erimu	e r i m u
kinene	k i n e n e
kyabulijjo	k y a b u l i j j o
ebavuga	e b a v u g a
lukuzibwa	l u k u z i b w a
obululu	o b u l u l u
litya	l i t y a
embaga	e m b a g a
ebimaamiddwa	e b i m a a m i d d w a
omukisa	o m u k i s a
boludda	b o l u d d a
omwami	o m w a m i
balala	b a l a l a
bawagira	b a w a g i r a
amakumi	a m a k u m i
tuzze	t u z z e
yatulagira	y a t u l a g i r a
kyebyobulamu	k y e b y o b u l a m u
mayiga	m a y i g a
etunuulirwa	e t u n u u l i r w a
y’enviiri	y ’ e n v i i r i
guvuga	g u v u g a
bizibu	b i z i b u
omuliro	o m u l i r o
kikaabizza	k i k a a b i z z a
okusaasaana	o k u s a a s a a n a
okutumbula	o k u t u m b u l a
okulya	o k u l y a
abasomesa	a b a s o m e s a
beeteeseteese	b e e t e e s e t e e s e
butuufu	b u t u u f u
waakalaba	w a a k a l a b a
wekkaanyenga	w e k k a a n y e n g a
kibiina	k i b i i n a
okunywegera	o k u n y w e g e r a
yakwegendereza	y a k w e g e n d e r e z a
bwe	b w e
asangiddwa	a s a n g i d d w a
agwana	a g w a n a
okukukusa	o k u k u k u s a
agira	a g i r a
kadde	k a d d e
yawaayo	y a w a a y o
ekifo	e k i f o
munaana	m u n a a n a
obulala	o b u l a l a
buko	b u k o
gomesi	g o m e s i
kubadde	k u b a d d e
mulala	m u l a l a
bw’akomawo	b w ’ a k o m a w o
bomu	b o m u
buganda	b u g a n d a
olowooza	o l o w o o z a
kwogera	k w o g e r a
ezobulabe	e z o b u l a b e
okututumula	o k u t u t u m u l a
ekyetaagisa	e k y e t a a g i s a
yansisinkana	y a n s i s i n k a n a
ennyingiko	e n n y i n g i k o
nnyo	n n y o
gyokwanjula	g y o k w a n j u l a
amabanja	a m a b a n j a
etunuulirirwa	e t u n u u l i r i r w a
waaliwo	w a a l i w o
essasi	e s s a s i
zabantu	z a b a n t u
enguudo	e n g u u d o
tiwaabanga	t i w a a b a n g a
tanzania	t a n z a n i a
ebyo	e b y o
kutendeka	k u t e n d e k a
ekyokunywa	e k y o k u n y w a
wakanyaamu	w a k a n y a a m u
ebuzaabuza	e b u z a a b u z a
z’abantu	z ’ a b a n t u
maama	m a a m a
ng’ekirala	n g ’ e k i r a l a
okukolebwa	o k u k o l e b w a
bwokukola	b w o k u k o l a
gayitibwa	g a y i t i b w a
yomwenkanonkano	y o m w e n k a n o n k a n o
tesobola	t e s o b o l a
munnabyabufuzi	m u n n a b y a b u f u z i
yalumbiddwa	y a l u m b i d d w a
oluganda	o l u g a n d a
ekyaana	e k y a a n a
mateeka	m a t e e k a
avunaanibwa	a v u n a a n i b w a
okukakasa	o k u k a k a s a
abeegendereza	a b e e g e n d e r e z a
tugende	t u g e n d e
baafunanga	b a a f u n a n g a
ebyokweroboza	e b y o k w e r o b o z a
abasaabaza	a b a s a a b a z a
kwennima	k w e n n i m a
oyogera	o y o g e r a
wali	w a l i
nanakuwala	n a n a k u w a l a
ngagoba	n g a g o b a
yafumba	y a f u m b a
yenna	y e n n a
lukiiko	l u k i i k o
emu	e m u
abawaddeyo	a b a w a d d e y o
bongera	b o n g e r a
bamuggyeko	b a m u g g y e k o
baasaba	b a a s a b a
ennyingi	e n n y i n g i
enkuba	e n k u b a
n’akunga	n ’ a k u n g a
birungo	b i r u n g o
eviirako	e v i i r a k o
lino	l i n o
musooke	m u s o o k e
muteesa	m u t e e s a
nengeri	n e n g e r i
okufumbirwa	o k u f u m b i r w a
okutema	o k u t e m a
abasajja	a b a s a j j a
akutte	a k u t t e
mwana	m w a n a
yensi	y e n s i
abalwadde	a b a l w a d d e
byenjigiriza	b y e n j i g i r i z a
ngennyama	n g e n n y a m a
kibuga	k i b u g a
ssomero	s s o m e r o
okuwaayo	o k u w a a y o
baana	b a a n a
zirabika	z i r a b i k a
bwosukka	b w o s u k k a
yatuweereza	y a t u w e e r e z a
buwambe	b u w a m b e
nolwekyo	n o l w e k y o
ekibiina	e k i b i i n a
lwomuggalo	l w o m u g g a l o
obwenjawulo	o b w e n j a w u l o
okumuziika	o k u m u z i i k a
enyiriri	e n y i r i r i
kkampuni	k k a m p u n i
bekkomera	b e k k o m e r a
tezirina	t e z i r i n a
tombuulira	t o m b u u l i r a
zabbibwa	z a b b i b w a
womwana	w o m w a n a
ekikajjo	e k i k a j j o
mukungu	m u k u n g u
mmutwalidde	m m u t w a l i d d e
ebiragiro	e b i r a g i r o
ebitajja	e b i t a j j a
okugikozesa	o k u g i k o z e s a
mpaayo	m p a a y o
omuyembe	o m u y e m b e
bateekateeka	b a t e e k a t e e k a
ngebulamu	n g e b u l a m u
abamu	a b a m u
sisobola	s i s o b o l a
agenjawulo	a g e n j a w u l o
mwonaasomeseza	m w o n a a s o m e s e z a
kwandiviirako	k w a n d i v i i r a k o
okukomolebwa	o k u k o m o l e b w a
omulungi	o m u l u n g i
byonoonebwa	b y o n o o n e b w a
pulogulamu	p u l o g u l a m u
dfcu	d f c u
abatuuka	a b a t u u k a
eziteekeddwawo	e z i t e e k e d d w a w o
bbanka	b b a n k a
abafumbo	a b a f u m b o
ani	a n i
otya	o t y a
bannaabwe	b a n n a a b w e
akwate	a k w a t e
bubaka	b u b a k a
omukambwe	o m u k a m b w e
okutulugunya	o k u t u l u g u n y a
namagye	n a m a g y e
abajulizi	a b a j u l i z i
alumya	a l u m y a
ekyongedde	e k y o n g e d d e
g’ekisajja	g ’ e k i s a j j a
okubirizibwa	o k u b i r i z i b w a
nabazzukulu	n a b a z z u k u l u
ebyomukyalo	e b y o m u k y a l o
yatwala	y a t w a l a
kumpi	k u m p i
abalyamu	a b a l y a m u
wenkiiko	w e n k i i k o
omuzito	o m u z i t o
ngeyisa	n g e y i s a
lweggulo	l w e g g u l o
kukola	k u k o l a
obudde	o b u d d e
byamawulire	b y a m a w u l i r e
kuzaala	k u z a a l a
yagambye	y a g a m b y e
zaawukana	z a a w u k a n a
bokka	b o k k a
okukungaanya	o k u k u n g a a n y a
bafuddeyo	b a f u d d e y o
abaawandiika	a b a a w a n d i i k a
ga	g a
anywako	a n y w a k o
ekiyitibwa	e k i y i t i b w a
eyampa	e y a m p a
kukuumiramu	k u k u u m i r a m u
okugenda	o k u g e n d a
kuyiga	k u y i g a
twafunangayo	t w a f u n a n g a y o
kirundu	k i r u n d u
ebeera	e b e e r a
ebirangibwa	e b i r a n g i b w a
biwa	b i w a
okusoomooza	o k u s o o m o o z a
byalo	b y a l o
eddagala	e d d a g a l a
waakiri	w a a k i r i
be	b e
yattiddwa	y a t t i d d w a
bukalubizza	b u k a l u b i z z a
ko	k o
zebayinza	z e b a y i n z a
mukulu	m u k u l u
z’omu	z ’ o m u
gamala	g a m a l a
kwennyini	k w e n n y i n i
kifo	k i f o
ekizimbe	e k i z i m b e
bakulembeze	b a k u l e m b e z e
liggwayo	l i g g w a y o
omusaala	o m u s a a l a
mobile	m o b i l e
nnyo	n n y o
baasobya	b a a s o b y a
bwagambako	b w a g a m b a k o
b’ekyalo	b ’ e k y a l o
tebaagendaga	t e b a a g e n d a g a
bitundu	b i t u n d u
enkwa	e n k w a
baakola	b a a k o l a
biweze	b i w e z e
zange	z a n g e
gukaawa	g u k a a w a
ensimbu	e n s i m b u
erikwata	e r i k w a t a
era	e r a
kyetaago	k y e t a a g o
mawuggwe	m a w u g g w e
okugema	o k u g e m a
ebyobulimi	e b y o b u l i m i
bandibadde	b a n d i b a d d e
masaka	m a s a k a
liriwa	l i r i w a
enkola	e n k o l a
eyonoonye	e y o n o o n y e
amasanyalaze	a m a s a n y a l a z e
ebiri	e b i r i
ekiranga	e k i r a n g a
okwemulugunya	o k w e m u l u g u n y a
kwabwe	k w a b w e
tusuubira	t u s u u b i r a
okuviirako	o k u v i i r a k o
bwa	b w a
ekikoola	e k i k o o l a
kusoboka	k u s o b o k a
money	m o n e y
mutono	m u t o n o
agaffe	a g a f f e
yeetaba	y e e t a b a
omubuulizi	o m u b u u l i z i
byetaagako	b y e t a a g a k o
okkulowoozesa	o k k u l o w o o z e s a
kukola	k u k o l a
omujjwa	o m u j j w a
okusaddaakibwa	o k u s a d d a a k i b w a
ebyettanirwa	e b y e t t a n i r w a
okuzisimattuka	o k u z i s i m a t t u k a
wano	w a n o
laba	l a b a
bwabakulembeze	b w a b a k u l e m b e z e
omukazi	o m u k a z i
corona	c o r o n a
longoosebwa	l o n g o o s e b w a
nsinga	n s i n g a
eyavaako	e y a v a a k o
okumulya	o k u m u l y a
basobola	b a s o b o l a
n’okugwa	n ’ o k u g w a
okuloopa	o k u l o o p a
nno	n n o
amannya	a m a n n y a
bano	b a n o
olukumi	o l u k u m i
kyatuukako	k y a t u u k a k o
basibibwe	b a s i b i b w e
abeetabye	a b e e t a b y e
nenkumi	n e n k u m i
bagannemeredde	b a g a n n e m e r e d d e
byobuwangwa	b y o b u w a n g w a
okuwulira	o k u w u l i r a
edda	e d d a
omupya	o m u p y a
ngakoowolera	n g a k o o w o l e r a
okwolesa	o k w o l e s a
olulaga	o l u l a g a
okwonoona	o k w o n o o n a
enkwe	e n k w e
mufulume	m u f u l u m e
wagulu	w a g u l u
ssomero	s s o m e r o
amafuta	a m a f u t a
emigaso	e m i g a s o
bakkakkamu	b a k k a k k a m u
beebuuza	b e e b u u z a
beegomba	b e e g o m b a
kaabuyonjo	k a a b u y o n j o
nendwadde	n e n d w a d d e
atulangidde	a t u l a n g i d d e
eza	e z a
tugenze	t u g e n z e
yasiima	y a s i i m a
bulabirizi	b u l a b i r i z i
omwepiskoopi	o m w e p i s k o o p i
b’olulimi	b ’ o l u l i m i
kuzimba	k u z i m b a
gwokuzimba	g w o k u z i m b a
bwerazi	b w e r a z i
olwebeeya	o l w e b e e y a
kabuga	k a b u g a
nobubaka	n o b u b a k a
abazuulwamu	a b a z u u l w a m u
abenjawulo	a b e n j a w u l o
akatono	a k a t o n o
bagumbulula	b a g u m b u l u l a
gomu	g o m u
libalirirwamu	l i b a l i r i r w a m u
nti	n t i
okulwanyisa	o k u l w a n y i s a
bayigiriza	b a y i g i r i z a
bufuzi	b u f u z i
obwo	o b w o
okuweereza	o k u w e e r e z a
kyabantu	k y a b a n t u
kukuza	k u k u z a
obukuumi	o b u k u u m i
nebitundu	n e b i t u n d u
yomu	y o m u
kibaamu	k i b a a m u
bwagobereranga	b w a g o b e r e r a n g a
bwamateeka	b w a m a t e e k a
byokubaluka	b y o k u b a l u k a
yayimiriza	y a y i m i r i z a
kkutegeeza	k k u t e g e e z a
kyamenvu	k y a m e n v u
etuulako	e t u u l a k o
ssembabuleyasabye	s s e m b a b u l e y a s a b y e
zeetabye	z e e t a b y e
kuggwa	k u g g w a
bwobeera	b w o b e e r a
abayigisa	a b a y i g i s a
omutindo	o m u t i n d o
z’ennimi	z ’ e n n i m i
ngobwavu	n g o b w a v u
ttawulo	t t a w u l o
gwafuuka	g w a f u u k a
ekule	e k u l e
kukukkuluma	k u k u k k u l u m a
bungi	b u n g i
ebyavudde	e b y a v u d d e
lwenda	l w e n d a
musanvu	m u s a n v u
kabonera	k a b o n e r a
omubeezi	o m u b e e z i
ebyo	e b y o
bammemba	b a m m e m b a
nedda	n e d d a
okuziyiza	o k u z i y i z a
kufa	k u f a
kusigala	k u s i g a l a
z’omukolo	z ’ o m u k o l o
‘ababbi	‘ a b a b b i
gewange	g e w a n g e
bagonjoola	b a g o n j o o l a
byebyo	b y e b y o
kwagala	k w a g a l a
ndagala	n d a g a l a
wiiiki	w i i i k i
yawadde	y a w a d d e
okusookasooka	o k u s o o k a s o o k a
eminene	e m i n e n e
ebyemirundi	e b y e m i r u n d i
emmere	e m m e r e
awamu	a w a m u
endabika	e n d a b i k a
eddalu	e d d a l u
kabaka	k a b a k a
bekitundu	b e k i t u n d u
abakyala	a b a k y a l a
yabantu	y a b a n t u
abagala	a b a g a l a
obutali	o b u t a l i
tumumma	t u m u m m a
obwa	o b w a
byabwe	b y a b w e
akantu	a k a n t u
mwaka	m w a k a
ateekewo	a t e e k e w o
kaasiya	k a a s i y a
nnazireka	n n a z i r e k a
ngeri	n g e r i
emiggo	e m i g g o
kinzijjukiza	k i n z i j j u k i z a
munnabusiro	m u n n a b u s i r o
bw’abantu	b w ’ a b a n t u
abawera	a b a w e r a
kumwelabira	k u m w e l a b i r a
okulemererwa	o k u l e m e r e r w a
eyolukoba	e y o l u k o b a
obuvunaanyizibwa	o b u v u n a a n y i z i b w a
kukyaza	k u k y a z a
gwebigere	g w e b i g e r e
boyogera	b o y o g e r a
ekyo	e k y o
kyonna	k y o n n a
etwala	e t w a l a
bbiri	b b i r i
tebafa	t e b a f a
abagagga	a b a g a g g a
agaliraanye	a g a l i r a a n y e
kyaffe	k y a f f e
ndi	n d i
ekisaawe	e k i s a a w e
kwewola	k w e w o l a
neyaabwe	n e y a a b w e
weesalirawo	w e e s a l i r a w o
kikula	k i k u l a
muganda	m u g a n d a
yakiraba	y a k i r a b a
bulemesa	b u l e m e s a
ebyokutambula	e b y o k u t a m b u l a
emu	e m u
mbeera	m b e e r a
olwokumanyisa	o l w o k u m a n y i s a
korona	k o r o n a
bwereere	b w e r e e r e
bawaanyisiganya	b a w a a n y i s i g a n y a
alemeddwa	a l e m e d d w a
obukadde	o b u k a d d e
byotamanyi	b y o t a m a n y i
kyoyagala	k y o y a g a l a
teyebalirira	t e y e b a l i r i r a
kwatuusibwa	k w a t u u s i b w a
abeyunga	a b e y u n g a
mbirowoozaamu	m b i r o w o o z a a m u
simulaba	s i m u l a b a
zaabwe	z a a b w e
awuliriza	a w u l i r i z a
ngava	n g a v a
akyeggyako	a k y e g g y a k o
bakutegeera	b a k u t e g e e r a
okumuwa	o k u m u w a
basawo	b a s a w o
omu	o m u
okukuumibwa	o k u k u u m i b w a
beera	b e e r a
benzikiriza	b e n z i k i r i z a
bangi	b a n g i
buteesa	b u t e e s a
kyayi	k y a y i
w’eggwanga	w ’ e g g w a n g a
layisinsi	l a y i s i n s i
enkaayana	e n k a a y a n a
maaso	m a a s o
egisoba	e g i s o b a
kyalooopye	k y a l o o o p y e
wamma	w a m m a
basabibwa	b a s a b i b w a
poliisi	p o l i i s i
fuba	f u b a
enkya	e n k y a
kufuna	k u f u n a
yaabwo	y a a b w o
basobole	b a s o b o l e
kitegekeddwa	k i t e g e k e d d w a
tosobola	t o s o b o l a
balonde	b a l o n d e
kutabangula	k u t a b a n g u l a
bwokugula	b w o k u g u l a
tekikkirizibwa	t e k i k k i r i z i b w a
okukwata	o k u k w a t a
ttulakita	t t u l a k i t a
omukazi	o m u k a z i
abatuumira	a b a t u u m i r a
byokulonda	b y o k u l o n d a
akakyo	a k a k y o
nokufuba	n o k u f u b a
zituuse	z i t u u s e
ennyiriri	e n n y i r i r i
okusadaka	o k u s a d a k a
bajja	b a j j a
poliisi	p o l i i s i
nenneeyisa	n e n n e e y i s a
okulwana	o k u l w a n a
obuweereza	o b u w e e r e z a
omusawo	o m u s a w o
kuleetera	k u l e e t e r a
kitongole	k i t o n g o l e
kubulankanya	k u b u l a n k a n y a
akola	a k o l a
buno	b u n o
emboozi	e m b o o z i
bikola	b i k o l a
ebitaali	e b i t a a l i
bayitamu	b a y i t a m u
okusobola	o k u s o b o l a
ebiddawo	e b i d d a w o
nakwo	n a k w o
mulekwa	m u l e k w a
okukikozesa	o k u k i k o z e s a
empandiika	e m p a n d i i k a
embi	e m b i
okwenenya	o k w e n e n y a
kweraga	k w e r a g a
nkambi	n k a m b i
ngomuzira	n g o m u z i r a
kwakawuka	k w a k a w u k a
tukuleetedde	t u k u l e e t e d d e
ensangi	e n s a n g i
gaalondebwa	g a a l o n d e b w a
baloopa	b a l o o p a
batuuka	b a t u u k a
nayongeza	n a y o n g e z a
kasooli	k a s o o l i
biba	b i b a
ekyo	e k y o
abakulumba	a b a k u l u m b a
keeraliikiriza	k e e r a l i i k i r i z a
munno	m u n n o
ssente	s s e n t e
byetaaga	b y e t a a g a
omulundi	o m u l u n d i
yokumulirwano	y o k u m u l i r w a n o
kalyoka	k a l y o k a
emidaala	e m i d a a l a
baabwe	b a a b w e
bagawa	b a g a w a
ennyanja	e n n y a n j a
bageyambise	b a g e y a m b i s e
zaffe	z a f f e
ekisinga	e k i s i n g a
lukale	l u k a l e
kuliko	k u l i k o
erabula	e r a b u l a
obukugu	o b u k u g u
teyateekerateekera	t e y a t e e k e r a t e e k e r a
mayonjo	m a y o n j o
kubawa	k u b a w a
teekateeka	t e e k a t e e k a
obwenkanya	o b w e n k a n y a
nsaba	n s a b a
y’abantu	y ’ a b a n t u
g’emmere	g ’ e m m e r e
ekyokukozesa	e k y o k u k o z e s a
nabuuza	n a b u u z a
okukyuka	o k u k y u k a
wawulidde	w a w u l i d d e
abavuzi	a b a v u z i
yo	y o
naawe	n a a w e
ziba	z i b a
lw’olimanya	l w ’ o l i m a n y a
oluddako	o l u d d a k o
mirembe	m i r e m b e
wokulwanyisa	w o k u l w a n y i s a
ensaasaana	e n s a a s a a n a
gateekebwawo	g a t e e k e b w a w o
gabantu	g a b a n t u
n’abantu	n ’ a b a n t u
ekyali	e k y a l i
kwava	k w a v a
okulamusa	o k u l a m u s a
kisa	k i s a
abateeberezebwa	a b a t e e b e r e z e b w a
okukola	o k u k o l a
satu	s a t u
tebwawula	t e b w a w u l a
okukirizza	o k u k i r i z z a
muwogo	m u w o g o
busatu	b u s a t u
ekkanisa	e k k a n i s a
omuduumizi	o m u d u u m i z i
kakalu	k a k a l u
mwagaanya	m w a g a a n y a
jjangu	j j a n g u
ebitali	e b i t a l i
abanafu	a b a n a f u
ekikozesa	e k i k o z e s a
buwaze	b u w a z e
emikisa	e m i k i s a
we	w e
obuto	o b u t o
ttaka	t t a k a
twakikoze	t w a k i k o z e
ssente	s s e n t e
nkulu	n k u l u
gutta	g u t t a
ddala	d d a l a
mukozi	m u k o z i
asuubirwa	a s u u b i r w a
yobugagga	y o b u g a g g a
abalya	a b a l y a
yakubiriza	y a k u b i r i z a
ngekitongole	n g e k i t o n g o l e
tulabe	t u l a b e
oyige	o y i g e
baayitamu	b a a y i t a m u
bawala	b a w a l a
tekinologiya	t e k i n o l o g i y a
magezi	m a g e z i
bibira	b i b i r a
ennene	e n n e n e
kukulako	k u k u l a k o
ndwadde	n d w a d d e
okwekebeza	o k w e k e b e z a
ekinene	e k i n e n e
ekola	e k o l a
atamidde	a t a m i d d e
ekikadde	e k i k a d d e
kibuga	k i b u g a
namagoba	n a m a g o b a
okutikkirwa	o k u t i k k i r w a
bingi	b i n g i
byabalwadde	b y a b a l w a d d e
okukuuma	o k u k u u m a
omusogozi	o m u s o g o z i
bakola	b a k o l a
kye	k y e
baabazinze	b a a b a z i n z e
kyolowooza	k y o l o w o o z a
kusoma	k u s o m a
agamu	a g a m u
okulyowa	o k u l y o w a
gwensiri	g w e n s i r i
bakimanye	b a k i m a n y e
olwaleero	o l w a l e e r o
kyabazinga	k y a b a z i n g a
gukendeddeko	g u k e n d e d d e k o
ebirowoozo	e b i r o w o o z o
yalemererwa	y a l e m e r e r w a
abaakosebwa	a b a a k o s e b w a
bimu	b i m u
ekintu	e k i n t u
ekitundu	e k i t u n d u
twakola	t w a k o l a
ngateekako	n g a t e e k a k o
amata	a m a t a
baazibbye	b a a z i b b y e
bizinensi	b i z i n e n s i
kibagwanidde	k i b a g w a n i d d e
okugezaako	o k u g e z a a k o
tegalina	t e g a l i n a
bakambwe	b a k a m b w e
balagajjalirwa	b a l a g a j j a l i r w a
university	u n i v e r s i t y
asimbibwa	a s i m b i b w a
ago	a g o
omubulizi	o m u b u l i z i
kyategeezezza	k y a t e g e e z e z z a
bwamufuula	b w a m u f u u l a
ffe	f f e
nebake	n e b a k e
ngessimu	n g e s s i m u
bwokubamu	b w o k u b a m u
ebitakwatibwa	e b i t a k w a t i b w a
kyabwe	k y a b w e
ebiyenje	e b i y e n j e
yabalokole	y a b a l o k o l e
emito	e m i t o
ziva	z i v a
bintu	b i n t u
byamuddamu	b y a m u d d a m u
nagalulira	n a g a l u l i r a
ebyafaayo	e b y a f a a y o
ssengenge	s s e n g e n g e
bw’obutiti	b w ’ o b u t i t i
abakozesa	a b a k o z e s a
entono	e n t o n o
kino	k i n o
gano	g a n o
emisango	e m i s a n g o
nkuba	n k u b a
teweesiize	t e w e e s i i z e
basuubiza	b a s u u b i z a
yabasawo	y a b a s a w o
bunnya	b u n n y a
ekifulimiziddwa	e k i f u l i m i z i d d w a
tiimi	t i i m i
kikula	k i k u l a
konna	k o n n a
auto	a u t o
ateekeddwa	a t e e k e d d w a
tetulina	t e t u l i n a
nja	n j a
myala	m y a l a
bannamawulire	b a n n a m a w u l i r e
abatu	a b a t u
okufa	o k u f a
ayogerako	a y o g e r a k o
bategeera	b a t e g e e r a
matono	m a t o n o
kkubbo	k k u b b o
kika	k i k a
bataliiwo	b a t a l i i w o
yenna	y e n n a
ngekiri	n g e k i r i
munne	m u n n e
abaliko	a b a l i k o
beetaaga	b e e t a a g a
baagenda	b a a g e n d a
eddembe	e d d e m b e
akiikirira	a k i i k i r i r a
minisitule	m i n i s i t u l e
musajja	m u s a j j a
amasomero	a m a s o m e r o
abenjawulo	a b e n j a w u l o
ssaabalabirizi	s s a a b a l a b i r i z i
babonerezebwa	b a b o n e r e z e b w a
ekibadde	e k i b a d d e
mpanvu	m p a n v u
bobubuddamu	b o b u b u d d a m u
ssatu	s s a t u
kinnyindwa	k i n n y i n d w a
businze	b u s i n z e
ekirala	e k i r a l a
zino	z i n o
tetulya	t e t u l y a
tebasobola	t e b a s o b o l a
wempaka	w e m p a k a
obwesigamiziddwa	o b w e s i g a m i z i d d w a
bakukozesa	b a k u k o z e s a
byomu	b y o m u
tekirina	t e k i r i n a
bwova	b w o v a
gyoku	g y o k u
endiirwa	e n d i i r w a
nze	n z e
okumatiza	o k u m a t i z a
agenti	a g e n t i
siringi	s i r i n g i
obutonde	o b u t o n d e
awagenda	a w a g e n d a
eddoboozi	e d d o b o o z i
zettaka	z e t t a k a
kusasulwa	k u s a s u l w a
ekirwadde	e k i r w a d d e
ezakawuka	e z a k a w u k a
twakyalira	t w a k y a l i r a
kaabuze	k a a b u z e
lwanga	l w a n g a
zitegekebwa	z i t e g e k e b w a
tubadde	t u b a d d e
ssigiri	s s i g i r i
gano	g a n o
tasaanye	t a s a a n y e
ennyo	e n n y o
nabasaba	n a b a s a b a
lyayo	l y a y o
bye	b y e
gwabasawo	g w a b a s a w o
omuwanguzi	o m u w a n g u z i
omubiri	o m u b i r i
noyo	n o y o
eno	e n o
ewange	e w a n g e
kiwandiiko	k i w a n d i i k o
gwabwe	g w a b w e
mwekuumenga	m w e k u u m e n g a
kikozesebwa	k i k o z e s e b w a
eyanirizza	e y a n i r i z z a
tebannatuuka	t e b a n n a t u u k a
gwazo	g w a z o
okuggyibwawo	o k u g g y i b w a w o
abafudde	a b a f u d d e
abalungi	a b a l u n g i
nobuyinza	n o b u y i n z a
ebyuma	e b y u m a
galeetera	g a l e e t e r a
abayamba	a b a y a m b a
yamukubye	y a m u k u b y e
temala	t e m a l a
omuvubuka	o m u v u b u k a
ebiri	e b i r i
zokuliyirira	z o k u l i y i r i r a
ebirungi	e b i r u n g i
ekisa	e k i s a
ggwe	g g w e
kwonna	k w o n n a
zebyobulamu	z e b y o b u l a m u
yandiddidde	y a n d i d d i d d e
kukozeseza	k u k o z e s e z a
alukweka	a l u k w e k a
ekinnumya	e k i n n u m y a
nnaleese	n n a l e e s e
baalukamu	b a a l u k a m u
nvunaanyizibwa	n v u n a a n y i z i b w a
mulala	m u l a l a
gyobwayaaya	g y o b w a y a a y a
ekibinja	e k i b i n j a
muzannyo	m u z a n n y o
balondebwa	b a l o n d e b w a
nzikiriza	n z i k i r i z a
ezebikyupuli	e z e b i k y u p u l i
bemisango	b e m i s a n g o
kaduukulu	k a d u u k u l u
yagambibwa	y a g a m b i b w a
okusobozesa	o k u s o b o z e s a
gwa	g w a
baalowooza	b a a l o w o o z a
yantegeeza	y a n t e g e e z a
tebagwa	t e b a g w a
nabatuuze	n a b a t u u z e
agalina	a g a l i n a
baabwe	b a a b w e
byetabiddwamu	b y e t a b i d d w a m u
zijja	z i j j a
busobola	b u s o b o l a
omuzeeyi	o m u z e e y i
zabavuganya	z a b a v u g a n y a
yalagira	y a l a g i r a
ebitone	e b i t o n e
kuteekeddwa	k u t e e k e d d w a
gwobulamu	g w o b u l a m u
nobuvunaanyizibwa	n o b u v u n a a n y i z i b w a
beetegefu	b e e t e g e f u
abatuufu	a b a t u u f u
ye	y e
be	b e
okyalina	o k y a l i n a
omukulu	o m u k u l u
mbaata	m b a a t a
gyonna	g y o n n a
abeewaayo	a b e e w a a y o
abasalimbira	a b a s a l i m b i r a
bataasa	b a t a a s a
esatu	e s a t u
eruubirira	e r u u b i r i r a
kusasula	k u s a s u l a
simuyamba	s i m u y a m b a
mmalirizza	m m a l i r i z z a
okuleetebwa	o k u l e e t e b w a
osuubira	o s u u b i r a
ekyawula	e k y a w u l a
okwanukula	o k w a n u k u l a
nteeseganya	n t e e s e g a n y a
na	n a
twazannya	t w a z a n n y a
zabayizi	z a b a y i z i
zebyobulamu	z e b y o b u l a m u
empya	e m p y a
nnabikoowa	n n a b i k o o w a
abasirikirwa	a b a s i r i k i r w a
ekicupule	e k i c u p u l e
akozesa	a k o z e s a
okulimbulula	o k u l i m b u l u l a
kyazira	k y a z i r a
e	e
bana	b a n a
nemisana	n e m i s a n a
tiketi	t i k e t i
omwenge	o m w e n g e
mwetegefu	m w e t e g e f u
baasabye	b a a s a b y e
gwabantu	g w a b a n t u
kujja	k u j j a
butono	b u t o n o
kusaanyawo	k u s a a n y a w o
tegaliimu	t e g a l i i m u
muwadde	m u w a d d e
eteeka	e t e e k a
zaabwe	z a a b w e
bannange	b a n n a n g e
kufumbirwa	k u f u m b i r w a
ensolo	e n s o l o
bakolerako	b a k o l e r a k o
obulimi	o b u l i m i
ekiyambako	e k i y a m b a k o
agattako	a g a t t a k o
embiriizi	e m b i r i i z i
twebuuzaako	t w e b u u z a a k o
egimenya	e g i m e n y a
lwenkyukakyuka	l w e n k y u k a k y u k a
kutendekebwa	k u t e n d e k e b w a
gukwata	g u k w a t a
omusomo	o m u s o m o
enjogera	e n j o g e r a
ojjukira	o j j u k i r a
ebirina	e b i r i n a
obwedda	o b w e d d a
kimenya	k i m e n y a
ye	y e
ekiseera	e k i s e e r a
ssigala	s s i g a l a
abasuula	a b a s u u l a
babulijjo	b a b u l i j j o
akalango	a k a l a n g o
gwagwe	g w a g w e
bafudde	b a f u d d e
bakakensa	b a k a k e n s a
nsobi	n s o b i
ebyenjawulo	e b y e n j a w u l o
abeddalu	a b e d d a l u
pulayimale	p u l a y i m a l e
yamasanyalaze	y a m a s a n y a l a z e
gaayonoonye	g a a y o n o o n y e
bambi	b a m b i
teyalina	t e y a l i n a
by’ebyokwerinda	b y ’ e b y o k w e r i n d a
ebyamaguzi	e b y a m a g u z i
gugenda	g u g e n d a
bukyusa	b u k y u s a
bamulekwa	b a m u l e k w a
otandika	o t a n d i k a
emyezi	e m y e z i
kikyuse	k i k y u s e
bwentyo	b w e n t y o
kuyingirira	k u y i n g i r i r a
nokulunda	n o k u l u n d a
butamanya	b u t a m a n y a
afumise	a f u m i s e
yakkirizza	y a k k i r i z z a
bu	b u
okuzimba	o k u z i m b a
kiteeka	k i t e e k a
lyemirimu	l y e m i r i m u
okwetegekera	o k w e t e g e k e r a
bokukyalo	b o k u k y a l o
busuulu	b u s u u l u
ssekabembe	s s e k a b e m b e
yasooka	y a s o o k a
kuwandiika	k u w a n d i i k a
tewakikolanga	t e w a k i k o l a n g a
yeekokkodde	y e e k o k k o d d e
nfubye	n f u b y e
lyabaana	l y a b a a n a
ena	e n a
abeera	a b e e r a
bakola	b a k o l a
embuzi	e m b u z i
lungi	l u n g i
gaggalwa	g a g g a l w a
yamanda	y a m a n d a
makanika	m a k a n i k a
abalina	a b a l i n a
waabwe	w a a b w e
okwetangira	o k w e t a n g i r a
kikuyamba	k i k u y a m b a
kampala	k a m p a l a
tuswalira	t u s w a l i r a
obunyama	o b u n y a m a
waayitawo	w a a y i t a w o
bwenjigiriza	b w e n j i g i r i z a
ntobazi	n t o b a z i
kidiba	k i d i b a
yatwalibwa	y a t w a l i b w a
ngagguse	n g a g g u s e
omuze	o m u z e
beebo	b e e b o
yakuba	y a k u b a
ebigenderera	e b i g e n d e r e r a
aggyayo	a g g y a y o
kukweka	k u k w e k a
nkomerero	n k o m e r e r o
tetwenkanankana	t e t w e n k a n a n k a n a
sitanza	s i t a n z a
bw’atuukiriddwa	b w ’ a t u u k i r i d d w a
yekka	y e k k a
omuwala	o m u w a l a
tebajjumbira	t e b a j j u m b i r a
abantu	a b a n t u
akasiiga	a k a s i i g a
ebiwuka	e b i w u k a
yawera	y a w e r a
birowoozesa	b i r o w o o z e s a
bwerinde	b w e r i n d e
muno	m u n o
awalonderwa	a w a l o n d e r w a
atukwatirwe	a t u k w a t i r w e
omusumba	o m u s u m b a
bakawuka	b a k a w u k a
ekubiriza	e k u b i r i z a
efunye	e f u n y e
ekiseera	e k i s e e r a
kibeera	k i b e e r a
kwomwaka	k w o m w a k a
nabo	n a b o
ssaalumanya	s s a a l u m a n y a
twongera	t w o n g e r a
zino	z i n o
zemipiira	z e m i p i i r a
kaali	k a a l i
omukulembeze	o m u k u l e m b e z e
ekkuumiro	e k k u u m i r o
batandike	b a t a n d i k e
babalirira	b a b a l i r i r a
kisolo	k i s o l o
kwawulamu	k w a w u l a m u
kutambuza	k u t a m b u z a
y’ebyenfuna	y ’ e b y e n f u n a
bukiikakkono	b u k i i k a k k o n o
eryo	e r y o
yalafuubana	y a l a f u u b a n a
ono	o n o
engereka	e n g e r e k a
pakwach	p a k w a c h
kwokka	k w o k k a
zabanoonyiboobubudamu	z a b a n o o n y i b o o b u b u d a m u
ekibalukawo	e k i b a l u k a w o
teyozebwa	t e y o z e b w a
ebyenjigiriza	e b y e n j i g i r i z a
zaabangamu	z a a b a n g a m u
kukulaakulana	k u k u l a a k u l a n a
esobola	e s o b o l a
yasengula	y a s e n g u l a
kkubo	k k u b o
ekukkulu	e k u k k u l u
katyabaga	k a t y a b a g a
mwebagenda	m w e b a g e n d a
ekikolwa	e k i k o l w a
yasiimye	y a s i i m y e
okuyamba	o k u y a m b a
ddembe	d d e m b e
ssenya	s s e n y a
amasannyalaze	a m a s a n n y a l a z e
ebibeetoolodde	e b i b e e t o o l o d d e
gwabalwadde	g w a b a l w a d d e
n’okuwenja	n ’ o k u w e n j a
ezaabwe	e z a a b w e
endagaano	e n d a g a a n o
kingi	k i n g i
obukulembeze	o b u k u l e m b e z e
ana	a n a
bikolwa	b i k o l w a
suukaali	s u u k a a l i
ly’okuwangaala	l y ’ o k u w a n g a a l a
ebibala	e b i b a l a
emyaka	e m y a k a
basuubira	b a s u u b i r a
gwali	g w a l i
obuuma	o b u u m a
byetaagisa	b y e t a a g i s a
kakuyege	k a k u y e g e
ziteeka	z i t e e k a
yatoloka	y a t o l o k a
tusobole	t u s o b o l e
akatale	a k a t a l e
matu	m a t u
mulambo	m u l a m b o
bakwatagane	b a k w a t a g a n e
yazze	y a z z e
ebimu	e b i m u
egisinga	e g i s i n g a
abamadi	a b a m a d i
ategeeza	a t e g e e z a
n’abantu	n ’ a b a n t u
namulaba	n a m u l a b a
kwongerayo	k w o n g e r a y o
abalala	a b a l a l a
lyebiyiiye	l y e b i y i i y e
yekikugu	y e k i k u g u
okuwandiisibwa	o k u w a n d i i s i b w a
balitandika	b a l i t a n d i k a
okukwatagana	o k u k w a t a g a n a
kizibu	k i z i b u
abato	a b a t o
kibuuzo	k i b u u z o
okujaguza	o k u j a g u z a
ebijanjaalo	e b i j a n j a a l o
atutte	a t u t t e
nnabadde	n n a b a d d e
ziwa	z i w a
okwebaza	o k w e b a z a
bituusa	b i t u u s a
mpozzi	m p o z z i
tetuyina	t e t u y i n a
waya	w a y a
kugula	k u g u l a
ensuku	e n s u k u
kano	k a n o
kkooti	k k o o t i
mulekwa	m u l e k w a
babbulooka	b a b b u l o o k a
kireetera	k i r e e t e r a
abagenda	a b a g e n d a
bisaanyawo	b i s a a n y a w o
eggwanga	e g g w a n g a
kikunzi	k i k u n z i
bakanoonyeze	b a k a n o o n y e z e
musolo	m u s o l o
nomukyala	n o m u k y a l a
agulibwa	a g u l i b w a
wessomero	w e s s o m e r o
g’abantu	g ’ a b a n t u
ebyapa	e b y a p a
gulinnya	g u l i n n y a
eyeebase	e y e e b a s e
kyejjuuni	k y e j j u u n i
okuliyingiramu	o k u l i y i n g i r a m u
namaliba	n a m a l i b a
nokuweereza	n o k u w e e r e z a
ngekikulu	n g e k i k u l u
kikumi	k i k u m i
mpeera	m p e e r a
obutale	o b u t a l e
obuli	o b u l i
lukwe	l u k w e
wakategeddeko	w a k a t e g e d d e k o
bakuba	b a k u b a
okubaawo	o k u b a a w o
bw’okumanya	b w ’ o k u m a n y a
nedda	n e d d a
abaddukanya	a b a d d u k a n y a
ensimbi	e n s i m b i
okweyongera	o k w e y o n g e r a
beegattidde	b e e g a t t i d d e
kitegeseewo	k i t e g e s e e w o
ttooyi	t t o o y i
abujje	a b u j j e
butanwa	b u t a n w a
ebisomesebwa	e b i s o m e s e b w a
kye	k y e
by’ensi	b y ’ e n s i
obulungi	o b u l u n g i
omukomazi	o m u k o m a z i
west	w e s t
eyokuyigirizaamu	e y o k u y i g i r i z a a m u
baayo	b a a y o
bavubuka	b a v u b u k a
bwoligenda	b w o l i g e n d a
ezenjawulo	e z e n j a w u l o
wamu	w a m u
gwange	g w a n g e
okugyoza	o k u g y o z a
omulamuzi	o m u l a m u z i
bw’amaliriza	b w ’ a m a l i r i z a
zisimba	z i s i m b a
namutegeera	n a m u t e g e e r a
obukugu	o b u k u g u
zomunda	z o m u n d a
ababeera	a b a b e e r a
waabwo	w a a b w o
byakoledde	b y a k o l e d d e
lwaki	l w a k i
okusoma	o k u s o m a
ensaamusaamu	e n s a a m u s a a m u
baffe	b a f f e
twatuula	t w a t u u l a
azaalibwa	a z a a l i b w a
essira	e s s i r a
weetaaga	w e e t a a g a
omubbi	o m u b b i
obukooti	o b u k o o t i
bebyalo	b e b y a l o
kubanga	k u b a n g a
kiwanuka	k i w a n u k a
namagezi	n a m a g e z i
okusinziira	o k u s i n z i i r a
ekisinga	e k i s i n g a
guganyula	g u g a n y u l a
bumenyi	b u m e n y i
wano	w a n o
kukyagenda	k u k y a g e n d a
kwa	k w a
gennyumba	g e n n y u m b a
kozessa	k o z e s s a
enkya	e n k y a
entangawuuzi	e n t a n g a w u u z i
emboga	e m b o g a
buteereddwa	b u t e e r e d d w a
n’ebintu	n ’ e b i n t u
wababiri	w a b a b i r i
enkonge	e n k o n g e
kiyamba	k i y a m b a
okuyisa	o k u y i s a
gavumentuti	g a v u m e n t u t i
okuweebwa	o k u w e e b w a
yeewaddeyo	y e e w a d d e y o
akafaananyi	a k a f a a n a n y i
gwo	g w o
lyabwe	l y a b w e
nggaali	n g g a a l i
omungi	o m u n g i
yalina	y a l i n a
batandise	b a t a n d i s e
kyekisanja	k y e k i s a n j a
obupande	o b u p a n d e
omukyala	o m u k y a l a
minisiture	m i n i s i t u r e
bandagirire	b a n d a g i r i r e
baagikolera	b a a g i k o l e r a
erinnya	e r i n n y a
zinnaffe	z i n n a f f e
baakera	b a a k e r a
kugwa	k u g w a
lutalo	l u t a l o
zebawa	z e b a w a
sennyiga	s e n n y i g a
ntono	n t o n o
gamala	g a m a l a
kirungi	k i r u n g i
okusika	o k u s i k a
bazimalira	b a z i m a l i r a
n’afuna	n ’ a f u n a
batono	b a t o n o
obutakkaanya	o b u t a k k a a n y a
ensibuko	e n s i b u k o
abantu	a b a n t u
bweetaaga	b w e e t a a g a
nonafuyira	n o n a f u y i r a
rotary	r o t a r y
baamuwa	b a a m u w a
nabambejja	n a b a m b e j j a
nfuna	n f u n a
mugattabantu	m u g a t t a b a n t u
abantu	a b a n t u
ensi	e n s i
yakakasizza	y a k a k a s i z z a
loopa	l o o p a
y’obulamu	y ’ o b u l a m u
bifu	b i f u
yobubakko	y o b u b a k k o
kitya	k i t y a
balungi	b a l u n g i
gw’abalonzi	g w ’ a b a l o n z i
bimuli	b i m u l i
emmotoka	e m m o t o k a
bebitundu	b e b i t u n d u
omuwendo	o m u w e n d o
nnaabakyala	n n a a b a k y a l a
bakaziikamu	b a k a z i i k a m u
ebyebbeeyi	e b y e b b e e y i
butukirivu	b u t u k i r i v u
abaana	a b a a n a
bulemenga	b u l e m e n g a
ova	o v a
y’omulundi	y ’ o m u l u n d i
zisaasaana	z i s a a s a a n a
amanyi	a m a n y i
okutabaganyaamu	o k u t a b a g a n y a a m u
ebirowoozo	e b i r o w o o z o
enduulu	e n d u u l u
lwakutaano	l w a k u t a a n o
muggalo	m u g g a l o
ekito	e k i t o
taano	t a a n o
wayisibwewo	w a y i s i b w e w o
bwerivaayo	b w e r i v a a y o
ggwe	g g w e
weewale	w e e w a l e
erisooka	e r i s o o k a
ekwasise	e k w a s i s e
east	e a s t
gusobola	g u s o b o l a
gyabwe	g y a b w e
okukolebwako	o k u k o l e b w a k o
olukwe	o l u k w e
bawaayiriza	b a w a a y i r i z a
kubalaba	k u b a l a b a
baawangaalanga	b a a w a n g a a l a n g a
emirembe	e m i r e m b e
munaana	m u n a a n a
eyo	e y o
lwonna	l w o n n a
bulya	b u l y a
ayina	a y i n a
kuziteeka	k u z i t e e k a
ogwokusatu	o g w o k u s a t u
ebiwandiikiddwa	e b i w a n d i i k i d d w a
ekkiriza	e k k i r i z a
baabulijjo	b a a b u l i j j o
kukkaanya	k u k k a a n y a
gyetukoma	g y e t u k o m a
ssaala	s s a a l a
tebaagala	t e b a a g a l a
lugogo	l u g o g o
ensobi	e n s o b i
bafunye	b a f u n y e
kenya	k e n y a
nebyennyanja	n e b y e n n y a n j a
boku	b o k u
bisolo	b i s o l o
omwesibyeko	o m w e s i b y e k o
simanyiiyo	s i m a n y i i y o
buwanguzi	b u w a n g u z i
ekirungi	e k i r u n g i
ajjudde	a j j u d d e
bwoyiseemu	b w o y i s e e m u
entegeerero	e n t e g e e r e r o
kyakuyigiriza	k y a k u y i g i r i z a
bali	b a l i
kirundabantu	k i r u n d a b a n t u
akawuka	a k a w u k a
okubuulira	o k u b u u l i r a
obutategeeraganagana	o b u t a t e g e e r a g a n a g a n a
maanyi	m a a n y i
ya	y a
oluvannyuma	o l u v a n n y u m a
okubeera	o k u b e e r a
gaabwe	g a a b w e
boogera	b o o g e r a
gendako	g e n d a k o
bansobera	b a n s o b e r a
okukolagana	o k u k o l a g a n a
okukulaakulanya	o k u k u l a a k u l a n y a
ebibiina	e b i b i i n a
genguudo	g e n g u u d o
okulongoosa	o k u l o n g o o s a
batuuyana	b a t u u y a n a
okuteekawo	o k u t e e k a w o
binyebwa	b i n y e b w a
amaduuka	a m a d u u k a
bututandise	b u t u t a n d i s e
ziri	z i r i
babbiddwa	b a b b i d d w a
kisiibo	k i s i i b o
mukyala	m u k y a l a
kunoonya	k u n o o n y a
ekisooka	e k i s o o k a
okusendasenda	o k u s e n d a s e n d a
okuziika	o k u z i i k a
obulimirunzi	o b u l i m i r u n z i
amawooteeri	a m a w o o t e e r i
byenfuna	b y e n f u n a
tewali	t e w a l i
ebirooto	e b i r o o t o
batambulira	b a t a m b u l i r a
baliva	b a l i v a
okulaba	o k u l a b a
nabakozi	n a b a k o z i
minene	m i n e n e
lyekinnansi	l y e k i n n a n s i
abali	a b a l i
kungi	k u n g i
wo	w o
kuteekawo	k u t e e k a w o
nti	n t i
kulungamya	k u l u n g a m y a
ssentebe	s s e n t e b e
amakungula	a m a k u n g u l a
omukama	o m u k a m a
bubi	b u b i
okusoomoozebwa	o k u s o o m o o z e b w a
olunaku	o l u n a k u
yalwanirira	y a l w a n i r i r a
kukakibwa	k u k a k i b w a
singa	s i n g a
ddwaliro	d d w a l i r o
egikungaanya	e g i k u n g a a n y a
okwettanira	o k w e t t a n i r a
okwagala	o k w a g a l a
ngotambula	n g o t a m b u l a
ziweze	z i w e z e
yasomesezza	y a s o m e s e z z a
kkwata	k k w a t a
likirizaako	l i k i r i z a a k o
okukubaganya	o k u k u b a g a n y a
ebivaamu	e b i v a a m u
okuyimirizaawo	o k u y i m i r i z a a w o
golomolo	g o l o m o l o
essanyu	e s s a n y u
esaba	e s a b a
gwandibadde	g w a n d i b a d d e
ekirooto	e k i r o o t o
obulabe	o b u l a b e
ngakaaba	n g a k a a b a
okutuusa	o k u t u u s a
y’okubukuumamu	y ’ o k u b u k u u m a m u
eziggyayo	e z i g g y a y o
yalwisibwa	y a l w i s i b w a
ateeberezebwa	a t e e b e r e z e b w a
kwekubagiza	k w e k u b a g i z a
baalabula	b a a l a b u l a
basanga	b a s a n g a
tamuliddemu	t a m u l i d d e m u
tezaawula	t e z a a w u l a
buzibu	b u z i b u
ebizibu	e b i z i b u
obutakungaanya	o b u t a k u n g a a n y a
bataputira	b a t a p u t i r a
yasoma	y a s o m a
lwa	l w a
okwegugunga	o k w e g u g u n g a
byokka	b y o k k a
kukungaanya	k u k u n g a a n y a
ddwaliro	d d w a l i r o
wankoko	w a n k o k o
taaba	t a a b a
waaliyo	w a a l i y o
beekwasa	b e e k w a s a
ebbali	e b b a l i
pulogula	p u l o g u l a
okunaaba	o k u n a a b a
essaza	e s s a z a
asinga	a s i n g a
bwo	b w o
kutulugunyizibwa	k u t u l u g u n y i z i b w a
tewali	t e w a l i
lwobulungi	l w o b u l u n g i
olumala	o l u m a l a
lukungaana	l u k u n g a a n a
bajeemedde	b a j e e m e d d e
omutamiivu	o m u t a m i i v u
bimu	b i m u
wamala	w a m a l a
buleeta	b u l e e t a
abalemeredwa	a b a l e m e r e d w a
ebidyeri	e b i d y e r i
yamulagira	y a m u l a g i r a
obukulu	o b u k u l u
gugaana	g u g a a n a
yagumizza	y a g u m i z z a
ebibuuzo	e b i b u u z o
tebyenkanankana	t e b y e n k a n a n k a n a
emalirizza	e m a l i r i z z a
kwotadde	k w o t a d d e
kunaaba	k u n a a b a
twasembayo	t w a s e m b a y o
obusookera	o b u s o o k e r a
kuddamu	k u d d a m u
lyomusujja	l y o m u s u j j a
omusajja	o m u s a j j a
bagume	b a g u m e
abannayuganda	a b a n n a y u g a n d a
butabanguko	b u t a b a n g u k o
agakugira	a g a k u g i r a
ku	k u
lijja	l i j j a
nabiryo	n a b i r y o
ogubadde	o g u b a d d e
amangiempeereza	a m a n g i e m p e e r e z a
amataba	a m a t a b a
amazzi	a m a z z i
lukokola	l u k o k o l a
abawerako	a b a w e r a k o
kuliyirira	k u l i y i r i r a
ennungi	e n n u n g i
kennyini	k e n n y i n i
gwenkaka	g w e n k a k a
totyanga	t o t y a n g a
gyo	g y o
ebadde	e b a d d e
ogwali	o g w a l i
banyagibwa	b a n y a g i b w a
bigenda	b i g e n d a
oguwedde	o g u w e d d e
paasita	p a a s i t a
n’oluswayiri	n ’ o l u s w a y i r i
engaba	e n g a b a
okuvuunikibwa	o k u v u u n i k i b w a
amulindirako	a m u l i n d i r a k o
ebimanyiddwa	e b i m a n y i d d w a
osaana	o s a a n a
mangu	m a n g u
abakubaganyi	a b a k u b a g a n y i
yingira	y i n g i r a
bazitwala	b a z i t w a l a
bukono	b u k o n o
bituufu	b i t u u f u
onokiyigiriza	o n o k i y i g i r i z a
mugattabantu	m u g a t t a b a n t u
akaagudde	a k a a g u d d e
gwejja	g w e j j a
kwekisaawe	k w e k i s a a w e
bwemisana	b w e m i s a n a
okkukolera	o k k u k o l e r a
abaagala	a b a a g a l a
gye	g y e
okusolobya	o k u s o l o b y a
bbiri	b b i r i
atuula	a t u u l a
genda	g e n d a
lwaleka	l w a l e k a
kati	k a t i
gyasigazza	g y a s i g a z z a
tegabaamu	t e g a b a a m u
basinga	b a s i n g a
bikolebwa	b i k o l e b w a
kkaddiyizo	k k a d d i y i z o
akadde	a k a d d e
namuganza	n a m u g a n z a
ekyokulabirako	e k y o k u l a b i r a k o
kyandireeta	k y a n d i r e e t a
zeetaaga	z e e t a a g a
enkulu	e n k u l u
boogera	b o o g e r a
azannya	a z a n n y a
nju	n j u
omu	o m u
tebakyasobola	t e b a k y a s o b o l a
n’ekyapa	n ’ e k y a p a
baakyo	b a a k y o
zebyobufuzi	z e b y o b u f u z i
enjovu	e n j o v u
mikisa	m i k i s a
abatta	a b a t t a
basibiramu	b a s i b i r a m u
omupiira	o m u p i i r a
bwoba	b w o b a
baazitaddeko	b a a z i t a d d e k o
nkubiriza	n k u b i r i z a
agasseeko	a g a s s e e k o
kibadde	k i b a d d e
badduukirira	b a d d u u k i r i r a
bantu	b a n t u
lyaffe	l y a f f e
memba	m e m b a
terina	t e r i n a
nalabula	n a l a b u l a
lukusa	l u k u s a
eggaddewo	e g g a d d e w o
tulya	t u l y a
obuteerabira	o b u t e e r a b i r a
obwamasumi	o b w a m a s u m i
nokubazzaamu	n o k u b a z z a a m u
ey’ekiganda	e y ’ e k i g a n d a
okuviira	o k u v i i r a
kweyongera	k w e y o n g e r a
sitenseni	s i t e n s e n i
amateeka	a m a t e e k a
abakkiririza	a b a k k i r i r i z a
afuba	a f u b a
kutumbula	k u t u m b u l a
gulwayo	g u l w a y o
yabayizi	y a b a y i z i
okuteekateeka	o k u t e e k a t e e k a
abadde	a b a d d e
atatabika	a t a t a b i k a
okuzibula	o k u z i b u l a
lyemirimu	l y e m i r i m u
obuyambi	o b u y a m b i
ababbi	a b a b b i
bamukyawa	b a m u k y a w a
mwaka	m w a k a
lubaale	l u b a a l e
okutendekebwa	o k u t e n d e k e b w a
ebiwerako	e b i w e r a k o
nabadde	n a b a d d e
z’okusomesa	z ’ o k u s o m e s a
awaka	a w a k a
kulinnya	k u l i n n y a
byansi	b y a n s i
makubo	m a k u b o
mukwano	m u k w a n o
tebagenda	t e b a g e n d a
lunaku	l u n a k u
abanoonyiboobubudamu	a b a n o o n y i b o o b u b u d a m u
kalifuuwa	k a l i f u u w a
obuwumbi	o b u w u m b i
foomu	f o o m u
covid	c o v i d
yekitundu	y e k i t u n d u
yetaaga	y e t a a g a
okubayimbula	o k u b a y i m b u l a
abatali	a b a t a l i
kalungi	k a l u n g i
epangisizza	e p a n g i s i z z a
okuyimirizaawo	o k u y i m i r i z a a w o
okutigomya	o k u t i g o m y a
bateekamu	b a t e e k a m u
b’eggwanga	b ’ e g g w a n g a
bakubirizibwa	b a k u b i r i z i b w a
muntu	m u n t u
abasinga	a b a s i n g a
ngomulwadde	n g o m u l w a d d e
nile	n i l e
neminyolo	n e m i n y o l o
ebyenjigiriza	e b y e n j i g i r i z a
bisatu	b i s a t u
batema	b a t e m a
bukwata	b u k w a t a
okutendeka	o k u t e n d e k a
zireetera	z i r e e t e r a
okuliteeka	o k u l i t e e k a
bwalemererwa	b w a l e m e r e r w a
okukendeeza	o k u k e n d e e z a
kusaabaza	k u s a a b a z a
ekisigaddeyo	e k i s i g a d d e y o
tukole	t u k o l e
atoloka	a t o l o k a
ngero	n g e r o
butya	b u t y a
oyagala	o y a g a l a
ebisoko	e b i s o k o
amateeka	a m a t e e k a
abakolera	a b a k o l e r a
ogwakutte	o g w a k u t t e
asatu	a s a t u
ebinyonyi	e b i n y o n y i
kwaweerezebwa	k w a w e e r e z e b w a
byabwe	b y a b w e
bulabe	b u l a b e
nobwenkanya	n o b w e n k a n y a
bannange	b a n n a n g e
yinginiya	y i n g i n i y a
arua	a r u a
zitambuza	z i t a m b u z a
bizinesi	b i z i n e s i
kakasa	k a k a s a
lujjuliro	l u j j u l i r o
towulira	t o w u l i r a
mangi	m a n g i
kusoma	k u s o m a
amawulire	a m a w u l i r e
olwakola	o l w a k o l a
bafuna	b a f u n a
saagala	s a a g a l a
gulina	g u l i n a
agatavaako	a g a t a v a a k o
ettaka	e t t a k a
kunyumyatunuulira	k u n y u m y a t u n u u l i r a
kebyokulonda	k e b y o k u l o n d a
okuva	o k u v a
muli	m u l i
okumeggana	o k u m e g g a n a
obutabayisa	o b u t a b a y i s a
tiimu	t i i m u
engendo	e n g e n d o
obuzireetera	o b u z i r e e t e r a
kitadde	k i t a d d e
kukunga	k u k u n g a
omuntu	o m u n t u
ebipya	e b i p y a
okweyongera	o k w e y o n g e r a
kye	k y e
mugaso	m u g a s o
omulabirizi	o m u l a b i r i z i
nnyingi	n n y i n g i
africa	a f r i c a
ebiyonjo	e b i y o n j o
ekisaale	e k i s a a l e
nsonga	n s o n g a
bukugu	b u k u g u
zino	z i n o
otya	o t y a
tegalimu	t e g a l i m u
n’ebirala	n ’ e b i r a l a
muntumulamu	m u n t u m u l a m u
bafa	b a f a
kalantiini	k a l a n t i i n i
obulumi	o b u l u m i
kyokutegeeza	k y o k u t e g e e z a
bonna	b o n n a
eyagabibwa	e y a g a b i b w a
olwa	o l w a
omutwe	o m u t w e
oluguudo	o l u g u u d o
yeetaga	y e e t a g a
gayina	g a y i n a
obutabbibwako	o b u t a b b i b w a k o
okutuula	o k u t u u l a
ddukanga	d d u k a n g a
tebaalina	t e b a a l i n a
tobya	t o b y a
eyawamu	e y a w a m u
lyogerwako	l y o g e r w a k o
yasoose	y a s o o s e
matumbibudde	m a t u m b i b u d d e
bamateeka	b a m a t e e k a
ebidomola	e b i d o m o l a
amberedewo	a m b e r e d e w o
okuliyirira	o k u l i y i r i r a
mutwe	m u t w e
dduyiro	d d u y i r o
yobudde	y o b u d d e
kufuuyira	k u f u u y i r a
wampimira	w a m p i m i r a
njambalirawo	n j a m b a l i r a w o
ekiso	e k i s o
amaaso	a m a a s o
bubaka	b u b a k a
batondawo	b a t o n d a w o
gwakawuka	g w a k a w u k a
kubunyisa	k u b u n y i s a
banka	b a n k a
faayo	f a a y o
nobukakkamu	n o b u k a k k a m u
baazimbudde	b a a z i m b u d d e
okukutulakutulamu	o k u k u t u l a k u t u l a m u
nakolera	n a k o l e r a
obwo	o b w o
kaakwata	k a a k w a t a
tebikyasomebwa	t e b i k y a s o m e b w a
mutabani	m u t a b a n i
ekiro	e k i r o
ekyemyaka	e k y e m y a k a
ngalo	n g a l o
bikusobera	b i k u s o b e r a
amawagala	a m a w a g a l a
kulya	k u l y a
mizibu	m i z i b u
kusasula	k u s a s u l a
okuziyizamu	o k u z i y i z a m u
bisale	b i s a l e
uganda	u g a n d a
nagenda	n a g e n d a
abana	a b a n a
ewadde	e w a d d e
kiriko	k i r i k o
kaawaase	k a a w a a s e
tebamanyi	t e b a m a n y i
bulumya	b u l u m y a
ejjambiya	e j j a m b i y a
amanene	a m a n e n e
omwana	o m w a n a
jjo	j j o
weetoloola	w e e t o l o o l a
twabadde	t w a b a d d e
egyasooka	e g y a s o o k a
ensawo	e n s a w o
okufuluma	o k u f u l u m a
kukusanyusa	k u k u s a n y u s a
okimanyi	o k i m a n y i
genjuba	g e n j u b a
tulina	t u l i n a
bamuggyeyo	b a m u g g y e y o
banjagala	b a n j a g a l a
okweteekamu	o k w e t e e k a m u
nokuba	n o k u b a
nsi	n s i
agambye	a g a m b y e
wabawala	w a b a w a l a
okutwaliza	o k u t w a l i z a
omusirikale	o m u s i r i k a l e
omuyita	o m u y i t a
royal	r o y a l
ebyenjawulo	e b y e n j a w u l o
obutaagala	o b u t a a g a l a
ewatali	e w a t a l i
gokunywa	g o k u n y w a
n’abagamba	n ’ a b a g a m b a
buwangwa	b u w a n g w a
tekimanyiddwa	t e k i m a n y i d d w a
okukulemberamu	o k u k u l e m b e r a m u
okusengulwa	o k u s e n g u l w a
kikuuma	k i k u u m a
loole	l o o l e
abagwa	a b a g w a
bujja	b u j j a
ekyo	e k y o
ky’enva	k y ’ e n v a
baganda	b a g a n d a
bentebbe	b e n t e b b e
kyebyenjigiriza	k y e b y e n j i g i r i z a
byemisolo	b y e m i s o l o
kukulaakulanya	k u k u l a a k u l a n y a
kiviiriddemu	k i v i i r i d d e m u
okwera	o k w e r a
tegasobola	t e g a s o b o l a
nemizannyo	n e m i z a n n y o
obulala	o b u l a l a
embera	e m b e r a
okugalinnyirira	o k u g a l i n n y i r i r a
emmeeme	e m m e e m e
bakozesa	b a k o z e s a
emitima	e m i t i m a
bivujjiridde	b i v u j j i r i d d e
bweyogerere	b w e y o g e r e r e
mboozi	m b o o z i
nkulaakulana	n k u l a a k u l a n a
abaami	a b a a m i
tatiddeemu	t a t i d d e e m u
eyongere	e y o n g e r e
kakunyumidde	k a k u n y u m i d d e
gonna	g o n n a
mmotoka	m m o t o k a
bazira	b a z i r a
obukubagiza	o b u k u b a g i z a
kubaganya	k u b a g a n y a
gwabadde	g w a b a d d e
okulwanya	o k u l w a n y a
kitangaala	k i t a n g a a l a
ereeta	e r e e t a
okwo	o k w o
ennaku	e n n a k u
nkuyege	n k u y e g e
balina	b a l i n a
bino	b i n o
gwennyamiza	g w e n n y a m i z a
okukula	o k u k u l a
tebakyakola	t e b a k y a k o l a
abatuliraanye	a b a t u l i r a a n y e
yali	y a l i
ebyobusuubuzi	e b y o b u s u u b u z i
bannayuganda	b a n n a y u g a n d a
baasuubiza	b a a s u u b i z a
gwensiri	g w e n s i r i
ggulu	g g u l u
ebisigalira	e b i s i g a l i r a
bakaayanira	b a k a a y a n i r a
obwokwemanya	o b w o k w e m a n y a
abalala	a b a l a l a
ebweru	e b w e r u
okukubisibwamu	o k u k u b i s i b w a m u
obumanyirivu	o b u m a n y i r i v u
kyeyambisibwe	k y e y a m b i s i b w e
yaleero	y a l e e r o
muntu	m u n t u
kigaya	k i g a y a
abakuumaddembe	a b a k u u m a d d e m b e
mateeka	m a t e e k a
alowooza	a l o w o o z a
asikiriza	a s i k i r i z a
kkapa	k k a p a
awo	a w o
liba	l i b a
olukwe	o l u k w e
kiragala	k i r a g a l a
obubi	o b u b i
owamaanyi	o w a m a a n y i
kyalo	k y a l o
yatenderezza	y a t e n d e r e z z a
obungi	o b u n g i
betutamanyi	b e t u t a m a n y i
esobodde	e s o b o d d e
bwetaavu	b w e t a a v u
ekimu	e k i m u
gyabwo	g y a b w o
oli	o l i
kuwozesa	k u w o z e s a
katonda	k a t o n d a
ekireetera	e k i r e e t e r a
ennamba	e n n a m b a
bali	b a l i
banywerera	b a n y w e r e r a
kyabwe	k y a b w e
kulima	k u l i m a
zizaala	z i z a a l a
enkolagana	e n k o l a g a n a
kaweefube	k a w e e f u b e
kiyimba	k i y i m b a
bonnabagaggawale	b o n n a b a g a g g a w a l e
nokukolera	n o k u k o l e r a
zokka	z o k k a
alumiziddwa	a l u m i z i d d w a
babeera	b a b e e r a
kulya	k u l y a
ssomero	s s o m e r o
wamu	w a m u
entobazi	e n t o b a z i
bakoma	b a k o m a
gaazo	g a a z o
obubaka	o b u b a k a
omuyiiya	o m u y i i y a
bantu	b a n t u
bangi	b a n g i
ssimu	s s i m u
emenyese	e m e n y e s e
abo	a b o
bwongo	b w o n g o
yategezezza	y a t e g e z e z z a
agakumala	a g a k u m a l a
kwakolebwa	k w a k o l e b w a
bannamikago	b a n n a m i k a g o
ate	a t e
makerere	m a k e r e r e
byembeera	b y e m b e e r a
amalwaliro	a m a l w a l i r o
ganyirira	g a n y i r i r a
yabika	y a b i k a
okukozesa	o k u k o z e s a
ekiro	e k i r o
nensi	n e n s i
obavangamu	o b a v a n g a m u
waggyeeko	w a g g y e e k o
bimenya	b i m e n y a
bwabwe	b w a b w e
bisomooza	b i s o m o o z a
eba	e b a
batta	b a t t a
bibanja	b i b a n j a
enzigi	e n z i g i
wamu	w a m u
zomu	z o m u
nambooze	n a m b o o z e
akubye	a k u b y e
bukoseddwa	b u k o s e d d w a
enguzi	e n g u z i
abatuuze	a b a t u u z e
gasiima	g a s i i m a
njeru	n j e r u
obwenzi	o b w e n z i
ekikola	e k i k o l a
tanaaba	t a n a a b a
mikono	m i k o n o
bulungi	b u l u n g i
kugasa	k u g a s a
yendwadde	y e n d w a d d e
nnakizuula	n n a k i z u u l a
otunula	o t u n u l a
tegikozesebwa	t e g i k o z e s e b w a
yafunye	y a f u n y e
yakyukira	y a k y u k i r a
bessomero	b e s s o m e r o
okukuwoomera	o k u k u w o o m e r a
eyokuweerezaamu	e y o k u w e e r e z a a m u
ezannya	e z a n n y a
temulina	t e m u l i n a
toziraba	t o z i r a b a
omukozi	o m u k o z i
olw’ebyo	o l w ’ e b y o
baamukutte	b a a m u k u t t e
kukotoggera	k u k o t o g g e r a
baakwatibwa	b a a k w a t i b w a
ebikwata	e b i k w a t a
ganyigiriza	g a n y i g i r i z a
obutamanya	o b u t a m a n y a
byomuggalo	b y o m u g g a l o
okutandika	o k u t a n d i k a
gy’abadde	g y ’ a b a d d e
koboko	k o b o k o
bibiina	b i b i i n a
olwokwewaayo	o l w o k w e w a a y o
abaagifuna	a b a a g i f u n a
baategeezezza	b a a t e g e e z e z z a
amatono	a m a t o n o
kituukibwako	k i t u u k i b w a k o
okubonaabona	o k u b o n a a b o n a
ntaddeko	n t a d d e k o
katebalirwe	k a t e b a l i r w e
ezimu	e z i m u
ntadde	n t a d d e
okwekussa	o k w e k u s s a
bakikola	b a k i k o l a
bazze	b a z z e
nnyo	n n y o
okulwanagana	o k u l w a n a g a n a
yalidde	y a l i d d e
obulemu	o b u l e m u
olwokumuvumira	o l w o k u m u v u m i r a
bataano	b a t a a n o
okusasula	o k u s a s u l a
pulezidenti	p u l e z i d e n t i
bazisasula	b a z i s a s u l a
nayolezanga	n a y o l e z a n g a
agoomunda	a g o o m u n d a
yengeri	y e n g e r i
bumu	b u m u
omukolo	o m u k o l o
baviira	b a v i i r a
ki	k i
babufunyeemu	b a b u f u n y e e m u
ttano	t t a n o
leero	l e e r o
obuwanguzi	o b u w a n g u z i
eyidde	e y i d d e
ebyasibwawo	e b y a s i b w a w o
byalo	b y a l o
gyogyagalamu	g y o g y a g a l a m u
okukuumibwa	o k u k u u m i b w a
nguudo	n g u u d o
yagamba	y a g a m b a
bana	b a n a
ebola	e b o l a
okugemebwa	o k u g e m e b w a
okutunda	o k u t u n d a
masomero	m a s o m e r o
mwanjo	m w a n j o
ezisaabaza	e z i s a a b a z a
bannaabwe	b a n n a a b w e
kyetaagisa	k y e t a a g i s a
otera	o t e r a
obuwanguzi	o b u w a n g u z i
wotuukira	w o t u u k i r a
erongooka	e r o n g o o k a
okukubiriza	o k u k u b i r i z a
be	b e
amuzeeyo	a m u z e e y o
kitaawe	k i t a a w e
migabo	m i g a b o
covid	c o v i d
nkumi	n k u m i
tebalina	t e b a l i n a
ezisiigibwa	e z i s i i g i b w a
nsowe	n s o w e
enkulaakulana	e n k u l a a k u l a n a
kimu	k i m u
okufaayo	o k u f a a y o
etambuza	e t a m b u z a
kyandibadde	k y a n d i b a d d e
mwanjo	m w a n j o
byayita	b y a y i t a
abeenyigira	a b e e n y i g i r a
amagoba	a m a g o b a
ntobazi	n t o b a z i
ebirala	e b i r a l a
ekyokuddamu	e k y o k u d d a m u
embi	e m b i
nfuga	n f u g a
waliwo	w a l i w o
ayagala	a y a g a l a
wattu	w a t t u
yaabwe	y a a b w e
zamazedda	z a m a z e d d a
akimanyidde	a k i m a n y i d d e
mitwe	m i t w e
yensibuko	y e n s i b u k o
omukungu	o m u k u n g u
ensimbi	e n s i m b i
okukulaakulana	o k u k u l a a k u l a n a
natta	n a t t a
okulambika	o k u l a m b i k a
okukola	o k u k o l a
kimuggyako	k i m u g g y a k o
ayonoonye	a y o n o o n y e
bodaboda	b o d a b o d a
abaganyuzi	a b a g a n y u z i
obuzitawaanya	o b u z i t a w a a n y a
okuyambako	o k u y a m b a k o
kwalina	k w a l i n a
togezaako	t o g e z a a k o
mpaka	m p a k a
kituuka	k i t u u k a
ekikungaanya	e k i k u n g a a n y a
kooti	k o o t i
nnagwedda	n n a g w e d d a
kitegeeza	k i t e g e e z a
essomero	e s s o m e r o
ababiri	a b a b i r i
ebimutakula	e b i m u t a k u l a
bi	b i
badduse	b a d d u s e
eteekeddwa	e t e e k e d d w a
okuyita	o k u y i t a
yavunaaniddwa	y a v u n a a n i d d w a
nnunda	n n u n d a
okusooka	o k u s o o k a
n’okuyamba	n ’ o k u y a m b a
kubuuza	k u b u u z a
abanoonyereza	a b a n o o n y e r e z a
byenkuba	b y e n k u b a
ente	e n t e
ndowooza	n d o w o o z a
nzija	n z i j a
eryobwebange	e r y o b w e b a n g e
tugezesa	t u g e z e s a
lesitulanta	l e s i t u l a n t a
ntensibe	n t e n s i b e
basanyufu	b a s a n y u f u
ekolera	e k o l e r a
egamba	e g a m b a
twagala	t w a g a l a
kituufu	k i t u u f u
okusaasaana	o k u s a a s a a n a
akizudde	a k i z u d d e
general	g e n e r a l
weggwannga	w e g g w a n n g a
bakwenyumirizaamu	b a k w e n y u m i r i z a a m u
bulijjo	b u l i j j o
ago	a g o
bo	b o
abasookerwako	a b a s o o k e r w a k o
bina	b i n a
bwazibidde	b w a z i b i d d e
obummonde	o b u m m o n d e
bayitira	b a y i t i r a
nasaba	n a s a b a
wajja	w a j j a
bawabya	b a w a b y a
abakazi	a b a k a z i
okwogereramu	o k w o g e r e r a m u
olwebyo	o l w e b y o
ebika	e b i k a
liri	l i r i
mugenda	m u g e n d a
alipoota	a l i p o o t a
wabanoonyi	w a b a n o o n y i
awatali	a w a t a l i
yokusaka	y o k u s a k a
akakiiko	a k a k i i k o
naddala	n a d d a l a
zo	z o
ekirala	e k i r a l a
abatalina	a b a t a l i n a
nsiko	n s i k o
emirimu	e m i r i m u
bangi	b a n g i
okugukola	o k u g u k o l a
mbuya	m b u y a
ngoli	n g o l i
omutono	o m u t o n o
okwetegereza	o k w e t e g e r e z a
okwelabira	o k w e l a b i r a
obukule	o b u k u l e
goofu	g o o f u
okuliisa	o k u l i i s a
ebiri	e b i r i
bizinensi	b i z i n e n s i
lwakuba	l w a k u b a
okugaba	o k u g a b a
ng’omukadde	n g ’ o m u k a d d e
mitwe	m i t w e
ngensimbi	n g e n s i m b i
byona	b y o n a
yenjuki	y e n j u k i
yaziikiddwa	y a z i i k i d d w a
etikkidde	e t i k k i d d e
tejja	t e j j a
nkaayana	n k a a y a n a
mmere	m m e r e
kyasigala	k y a s i g a l a
ssemateeka	s s e m a t e e k a
bobubudamu	b o b u b u d a m u
sikaala	s i k a a l a
abangu	a b a n g u
mirimu	m i r i m u
tteeka	t t e e k a
agasukkiridde	a g a s u k k i r i d d e
kuzzo	k u z z o
genkuba	g e n k u b a
bibonerezo	b i b o n e r e z o
emmere	e m m e r e
omuzannyi	o m u z a n n y i
beetaga	b e e t a g a
muwandiikiragana	m u w a n d i i k i r a g a n a
kaggwa	k a g g w a
ebikujjuko	e b i k u j j u k o
osabanga	o s a b a n g a
munene	m u n e n e
tebakoma	t e b a k o m a
gyomutimbagano	g y o m u t i m b a g a n o
ezitwala	e z i t w a l a
abakunukkiriza	a b a k u n u k k i r i z a
bakolera	b a k o l e r a
nkanyi	n k a n y i
yazikidde	y a z i k i d d e
pulojekiti	p u l o j e k i t i
ebyokuwabya	e b y o k u w a b y a
buyitibwa	b u y i t i b w a
myaka	m y a k a
ayitidde	a y i t i d d e
mazzi	m a z z i
bbeeyi	b b e e y i
kisa	k i s a
bingi	b i n g i
nankwatirako	n a n k w a t i r a k o
abobuyinza	a b o b u y i n z a
okumuloopera	o k u m u l o o p e r a
yandifuna	y a n d i f u n a
biyambye	b i y a m b y e
baatambulanga	b a a t a m b u l a n g a
omubaka	o m u b a k a
ebyenkizo	e b y e n k i z o
ekyomutawaana	e k y o m u t a w a a n a
anaatera	a n a a t e r a
kwabavubuka	k w a b a v u b u k a
omusiike	o m u s i i k e
gavumenti	g a v u m e n t i
arua	a r u a
bwabantu	b w a b a n t u
muko	m u k o
okutangaavu	o k u t a n g a a v u
bannabyabufuzi	b a n n a b y a b u f u z i
basatu	b a s a t u
zabantu	z a b a n t u
nokuzaala	n o k u z a a l a
takwagala	t a k w a g a l a
yange	y a n g e
bensi	b e n s i
ezolukale	e z o l u k a l e
yebyettaka	y e b y e t t a k a
basuubirwa	b a s u u b i r w a
lyonna	l y o n n a
gwensimbi	g w e n s i m b i
omukebe	o m u k e b e
nsanvu	n s a n v u
kisse	k i s s e
obukodyo	o b u k o d y o
eya	e y a
lye	l y e
omperekereko	o m p e r e k e r e k o
tosaanidde	t o s a a n i d d e
yomusaala	y o m u s a a l a
bakyakozesa	b a k y a k o z e s a
ly’omuzannyo	l y ’ o m u z a n n y o
agaafiiriddwako	a g a a f i i r i d d w a k o
ebweru	e b w e r u
ebitongole	e b i t o n g o l e
kwendwadde	k w e n d w a d d e
nnatamwa	n n a t a m w a
okugamba	o k u g a m b a
akakuubagano	a k a k u u b a g a n o
yeetegese	y e e t e g e s e
okwongera	o k w o n g e r a
yonna	y o n n a
abakakkamu	a b a k a k k a m u
emikono	e m i k o n o
bwebyobufuzi	b w e b y o b u f u z i
okugabira	o k u g a b i r a
abekisa	a b e k i s a
okwamazima	o k w a m a z i m a
ngayagala	n g a y a g a l a
kwabantu	k w a b a n t u
abatandise	a b a t a n d i s e
alemererwe	a l e m e r e r w e
kitundu	k i t u n d u
kinaana	k i n a a n a
ebiriwo	e b i r i w o
amanyiddwa	a m a n y i d d w a
nanenya	n a n e n y a
teller	t e l l e r
bannange	b a n n a n g e
okubwekuuma	o k u b w e k u u m a
ssenyiga	s s e n y i g a
kuzzaamu	k u z z a a m u
nabwo	n a b w o
okuggalawo	o k u g g a l a w o
amaanyi	a m a a n y i
bitono	b i t o n o
gwokka	g w o k k a
kibazzaamu	k i b a z z a a m u
bwabwe	b w a b w e
omuddo	o m u d d o
kwambala	k w a m b a l a
nti	n t i
yamuwa	y a m u w a
okumulaba	o k u m u l a b a
bbala	b b a l a
talidde	t a l i d d e
ente	e n t e
tetwalonda	t e t w a l o n d a
olutalo	o l u t a l o
kuzannyira	k u z a n n y i r a
ziriko	z i r i k o
enguzi	e n g u z i
giba	g i b a
mpaka	m p a k a
yabaana	y a b a a n a
nabazzi	n a b a z z i
kutegeerekeka	k u t e g e e r e k e k a
okutereeza	o k u t e r e e z a
kovidi	k o v i d i
esembezza	e s e m b e z z a
yembwa	y e m b w a
biramu	b i r a m u
badda	b a d d a
kinaaba	k i n a a b a
bakoze	b a k o z e
gankuba	g a n k u b a
ekiva	e k i v a
osobola	o s o b o l a
ekitundu	e k i t u n d u
kutuusa	k u t u u s a
nsomesa	n s o m e s a
mirowooza	m i r o w o o z a
endwadde	e n d w a d d e
okukomya	o k u k o m y a
okuttingana	o k u t t i n g a n a
eyanguyira	e y a n g u y i r a
banoonyeza	b a n o o n y e z a
musaabaze	m u s a a b a z e
bisoopu	b i s o o p u
ebikolwa	e b i k o l w a
n’amuwa	n ’ a m u w a
batte	b a t t e
ebbiri	e b b i r i
bibiina	b i b i i n a
mulimu	m u l i m u
obulamu	o b u l a m u
byabanoonyi	b y a b a n o o n y i
kulonda	k u l o n d a
teziriimu	t e z i r i i m u
kyeraliikirizza	k y e r a l i i k i r i z z a
akazannyo	a k a z a n n y o
ssaati	s s a a t i
abasibe	a b a s i b e
olusolobyo	o l u s o l o b y o
kijja	k i j j a
ngabakazi	n g a b a k a z i
bateeberezebwa	b a t e e b e r e z e b w a
kuteeka	k u t e e k a
g’ennaku	g ’ e n n a k u
tukola	t u k o l a
tawagira	t a w a g i r a
kkojjaawe	k k o j j a a w e
bbayibuli	b b a y i b u l i
ebibira	e b i b i r a
dda	d d a
emisolo	e m i s o l o
awamu	a w a m u
bulwa	b u l w a
basattira	b a s a t t i r a
bambuulira	b a m b u u l i r a
baavaayo	b a a v a a y o
abayita	a b a y i t a
emikutu	e m i k u t u
byakamalirizo	b y a k a m a l i r i z o
abayizi	a b a y i z i
yeetaaga	y e e t a a g a
giremesezza	g i r e m e s e z z a
bonna	b o n n a
kisimbyewo	k i s i m b y e w o
mutwe	m u t w e
siwummula	s i w u m m u l a
okugoba	o k u g o b a
kyabantu	k y a b a n t u
tutya	t u t y a
bamukuba	b a m u k u b a
tabaaga	t a b a a g a
olwo	o l w o
mukazi	m u k a z i
omuzungu	o m u z u n g u
enjuki	e n j u k i
kibuule	k i b u u l e
yaabwe	y a a b w e
ako	a k o
omukka	o m u k k a
baasiima	b a a s i i m a
batera	b a t e r a
mwezi	m w e z i
bungi	b u n g i
kiyonjo	k i y o n j o
abakwatiddwa	a b a k w a t i d d w a
yagaba	y a g a b a
okusomesa	o k u s o m e s a
webuli	w e b u l i
okwongerayo	o k w o n g e r a y o
nekitongole	n e k i t o n g o l e
emigattabantu	e m i g a t t a b a n t u
lwoba	l w o b a
kyamawanga	k y a m a w a n g a
beeyisa	b e e y i s a
tomanyi	t o m a n y i
ekiddugavu	e k i d d u g a v u
owange	o w a n g e
nnaku	n n a k u
ofunye	o f u n y e
gwokusosola	g w o k u s o s o l a
yebintu	y e b i n t u
okujjanjabibwa	o k u j j a n j a b i b w a
ziwagira	z i w a g i r a
abatannaba	a b a t a n n a b a
kwennyonnyolako	k w e n n y o n n y o l a k o
neyongera	n e y o n g e r a
tebazitwala	t e b a z i t w a l a
yasuubiza	y a s u u b i z a
yawandiika	y a w a n d i i k a
baazuuliddwamu	b a a z u u l i d d w a m u
okwobuwaze	o k w o b u w a z e
oluganda	o l u g a n d a
kukolera	k u k o l e r a
baalyekanze	b a a l y e k a n z e
bataano	b a t a a n o
natandika	n a t a n d i k a
egisukka	e g i s u k k a
ebikuuma	e b i k u u m a
mukama	m u k a m a
eyasomboola	e y a s o m b o o l a
mwebale	m w e b a l e
kangaawo	k a n g a a w o
okukyusa	o k u k y u s a
amawanga	a m a w a n g a
eddungi	e d d u n g i
eejja	e e j j a
okulabira	o k u l a b i r a
okugeraageranya	o k u g e r a a g e r a n y a
zobukaba	z o b u k a b a
masiki	m a s i k i
gi	g i
ngoggyeko	n g o g g y e k o
ka	k a
bayingira	b a y i n g i r a
tetugenda	t e t u g e n d a
ezineetoolodde	e z i n e e t o o l o d d e
nnabubaawo	n n a b u b a a w o
enjawukana	e n j a w u k a n a
ezebbeeyi	e z e b b e e y i
buvunaanyizibwa	b u v u n a a n y i z i b w a
mubiri	m u b i r i
ziteekeddwa	z i t e e k e d d w a
obwamabalibwa	o b w a m a b a l i b w a
mawanga	m a w a n g a
okumuyamba	o k u m u y a m b a
ndeeteraayo	n d e e t e r a a y o
ennyumba	e n n y u m b a
ebyetaagisa	e b y e t a a g i s a
ezimu	e z i m u
kugema	k u g e m a
baateebwa	b a a t e e b w a
si	s i
okuzaala	o k u z a a l a
mwagala	m w a g a l a
abantu	a b a n t u
olwekirwadde	o l w e k i r w a d d e
eyali	e y a l i
efubye	e f u b y e
eziwerako	e z i w e r a k o
weggwanga	w e g g w a n g a
ddi	d d i
okutuukirira	o k u t u u k i r i r a
eno	e n o
okusiga	o k u s i g a
batakituukiriza	b a t a k i t u u k i r i z a
kiyungu	k i y u n g u
ekikozesebwa	e k i k o z e s e b w a
tusaba	t u s a b a
kweyongedde	k w e y o n g e d d e
abavumu	a b a v u m u
okulondawo	o k u l o n d a w o
okuwangula	o k u w a n g u l a
kukuyamba	k u k u y a m b a
luguudo	l u g u u d o
nazzikuno	n a z z i k u n o
ebivvulu	e b i v v u l u
leero	l e e r o
emisana	e m i s a n a
ategeezezza	a t e g e e z e z z a
kiruma	k i r u m a
semina	s e m i n a
enfaanana	e n f a a n a n a
ekyomukisa	e k y o m u k i s a
bumu	b u m u
bw’okuwuliziganya	b w ’ o k u w u l i z i g a n y a
luggya	l u g g y a
gyekitundu	g y e k i t u n d u
obulemu	o b u l e m u
tuba	t u b a
babba	b a b b a
abaagalwa	a b a a g a l w a
akaguwa	a k a g u w a
gyetaagisa	g y e t a a g i s a
eddwaliro	e d d w a l i r o
okutwala	o k u t w a l a
bwaba	b w a b a
emitwalo	e m i t w a l o
enkofu	e n k o f u
bakulembera	b a k u l e m b e r a
babaggyako	b a b a g g y a k o
agenderera	a g e n d e r e r a
agomugaso	a g o m u g a s o
ebyobulamu	e b y o b u l a m u
gumu	g u m u
balowooza	b a l o w o o z a
abato	a b a t o
kisindika	k i s i n d i k a
engalo	e n g a l o
enseenene	e n s e e n e n e
nomu	n o m u
emizannyo	e m i z a n n y o
nokubagabira	n o k u b a g a b i r a
gebisolo	g e b i s o l o
ebirimu	e b i r i m u
mubayambeko	m u b a y a m b e k o
abakozi	a b a k o z i
yakubiddwa	y a k u b i d d w a
wa	w a
yomuntu	y o m u n t u
emigattabantu	e m i g a t t a b a n t u
mukuumaddamula	m u k u u m a d d a m u l a
famire	f a m i r e
abasawo	a b a s a w o
alinda	a l i n d a
ebigenge	e b i g e n g e
freehold	f r e e h o l d
okunoonyereza	o k u n o o n y e r e z a
afaayo	a f a a y o
ereme	e r e m e
byettaka	b y e t t a k a
biyamba	b i y a m b a
okuwona	o k u w o n a
amagombolola	a m a g o m b o l o l a
akyalire	a k y a l i r e
kwekulula	k w e k u l u l a
ebibinja	e b i b i n j a
kyekirwadde	k y e k i r w a d d e
oyo	o y o
kuzaalibwa	k u z a a l i b w a
bizigo	b i z i g o
enguzi	e n g u z i
bazadde	b a z a d d e
ekirowoozo	e k i r o w o o z o
tayinza	t a y i n z a
okwewandisa	o k w e w a n d i s a
wetuuse	w e t u u s e
abakkiriziddwa	a b a k k i r i z i d d w a
ogusooka	o g u s o o k a
obwokuyunga	o b w o k u y u n g a
basituse	b a s i t u s e
gwokuvuga	g w o k u v u g a
kyokka	k y o k k a
olulimi	o l u l i m i
kyannema	k y a n n e m a
kukigumiikiriza”	k u k i g u m i i k i r i z a ”
lyebisolo	l y e b i s o l o
kukozesebwa	k u k o z e s e b w a
nokulumya	n o k u l u m y a
guno	g u n o
asiwa	a s i w a
embeera	e m b e e r a
agakola	a g a k o l a
yokusemberera	y o k u s e m b e r e r a
kasse	k a s s e
gavumenti	g a v u m e n t i
budde	b u d d e
muyige	m u y i g e
amaziga	a m a z i g a
abedda	a b e d d a
kiwa	k i w a
museveni	m u s e v e n i
mbadde	m b a d d e
yabadde	y a b a d d e
byaffe	b y a f f e
obwogeza	o b w o g e z a
eddaala	e d d a a l a
amulabamu	a m u l a b a m u
red	r e d
okubaako	o k u b a a k o
byebyafaayo	b y e b y a f a a y o
busirisi	b u s i r i s i
omubisi	o m u b i s i
omusomesa	o m u s o m e s a
mu	m u
gateekebwa	g a t e e k e b w a
abavuka	a b a v u k a
atambule	a t a m b u l e
eyinza	e y i n z a
kyakuba	k y a k u b a
emisoso	e m i s o s o
ebibuuzo	e b i b u u z o
nettaka	n e t t a k a
ssebo	s s e b o
umeme	u m e m e
ekyokubagaana	e k y o k u b a g a a n a
wolubiri	w o l u b i r i
emirundi	e m i r u n d i
kusuubirwa	k u s u u b i r w a
ekkovu	e k k o v u
lwabakyala	l w a b a k y a l a
munne	m u n n e
baasulanga	b a a s u l a n g a
wabasumba	w a b a s u m b a
okunonya	o k u n o n y a
okubayambako	o k u b a y a m b a k o
olw’ekirwadde	o l w ’ e k i r w a d d e
okusanga	o k u s a n g a
