dduuka	d d u u k a
banka	b a n k a
yayita	y a y i t a
lyabwe	l y a b w e
tulina	t u l i n a
ggwanga	g g w a n g a
ennaku	e n n a k u
osobola	o s o b o l a
okufuna	o k u f u n a
nzirugavu	n z i r u g a v u
bw’akomawo	b w ’ a k o m a w o
weyamulengerera	w e y a m u l e n g e r e r a
okulaba	o k u l a b a
nengoye	n e n g o y e
balina	b a l i n a
basobole	b a s o b o l e
omusawo	o m u s a w o
ngero	n g e r o
dduuka	d d u u k a
omulenzi	o m u l e n z i
nnyo	n n y o
olukiiko	o l u k i i k o
yamusaba	y a m u s a b a
wankoko	w a n k o k o
omusirikale	o m u s i r i k a l e
esobola	e s o b o l a
emugga	e m u g g a
talidde	t a l i d d e
lyali	l y a l i
kadde	k a d d e
nebintu	n e b i n t u
baali	b a a l i
muwogo	m u w o g o
abakwatiddwa	a b a k w a t i d d w a
essundiro	e s s u n d i r o
yatandika	y a t a n d i k a
ekikola	e k i k o l a
byabantu	b y a b a n t u
alina	a l i n a
nti	n t i
kituufu	k i t u u f u
teyita	t e y i t a
loole	l o o l e
omubi	o m u b i
takyalaba	t a k y a l a b a
emenyese	e m e n y e s e
eddiini	e d d i i n i
okukola	o k u k o l a
nnyingi	n n y i n g i
toyagala	t o y a g a l a
omuyizi	o m u y i z i
ddagala	d d a g a l a
okusomera	o k u s o m e r a
empale	e m p a l e
kaduukulu	k a d u u k u l u
lukokola	l u k o k o l a
akizudde	a k i z u d d e
paalamenti	p a a l a m e n t i
mbadde	m b a d d e
tebigobererwa	t e b i g o b e r e r w a
gaazo	g a a z o
kumpi	k u m p i
wano	w a n o
omubbi	o m u b b i
okwekuuma	o k w e k u u m a
ssebo	s s e b o
baalowooza	b a a l o w o o z a
mukyala	m u k y a l a
gukendeddeko	g u k e n d e d d e k o
otandika	o t a n d i k a
mateeka	m a t e e k a
muyizi	m u y i z i
omuzito	o m u z i t o
ekisinga	e k i s i n g a
akalaga	a k a l a g a
abawagizi	a b a w a g i z i
g’ekisajja	g ’ e k i s a j j a
kabonero	k a b o n e r o
kkondo	k k o n d o
mpaayo	m p a a y o
abakozi	a b a k o z i
bifo	b i f o
okusalawo	o k u s a l a w o
omunaanaansi	o m u n a a n a a n s i
kata	k a t a
kyatuukako	k y a t u u k a k o
	
kuba	k u b a
bannayuganda	b a n n a y u g a n d a
ofunamu	o f u n a m u
kulya	k u l y a
eziyingira	e z i y i n g i r a
kimuleetera	k i m u l e e t e r a
ssimu	s s i m u
okuliraaana	o k u l i r a a a n a
muno	m u n o
okutuusa	o k u t u u s a
n’amaka	n ’ a m a k a
ddala	d d a l a
fuba	f u b a
okusaddaakibwa	o k u s a d d a a k i b w a
katonda	k a t o n d a
yafesi	y a f e s i
nebifo	n e b i f o
kukulira	k u k u l i r a
wabweru	w a b w e r u
kimuggyako	k i m u g g y a k o
yantegeeza	y a n t e g e e z a
okutunda	o k u t u n d a
gw’abakazi	g w ’ a b a k a z i
amulindirako	a m u l i n d i r a k o
agenda	a g e n d a
omulimu	o m u l i m u
kwambala	k w a m b a l a
waliwo	w a l i w o
basattira	b a s a t t i r a
nabitunda	n a b i t u n d a
bakwenyumirizaamu	b a k w e n y u m i r i z a a m u
kulina	k u l i n a
wamma	w a m m a
awo	a w o
kusasula	k u s a s u l a
okimanyi	o k i m a n y i
mulamu	m u l a m u
poliisi	p o l i i s i
kimugwanira	k i m u g w a n i r a
ge	g e
bulungi	b u l u n g i
omugenzi	o m u g e n z i
okuyimirizaawo	o k u y i m i r i z a a w o
tolina	t o l i n a
era	e r a
kugenda	k u g e n d a
muko	m u k o
kaabuze	k a a b u z e
abato	a b a t o
za	z a
zizaala	z i z a a l a
bukadde	b u k a d d e
nnaleese	n n a l e e s e
batte	b a t t e
okusibwa	o k u s i b w a
ekibuga	e k i b u g a
magoba	m a g o b a
tewaaliwo	t e w a a l i w o
eba	e b a
abatuuze	a b a t u u z e
togezaako	t o g e z a a k o
akantu	a k a n t u
ssaati	s s a a t i
ebintu	e b i n t u
emyoyo	e m y o y o
mulekwa	m u l e k w a
bateekwa	b a t e e k w a
gwe	g w e
minene	m i n e n e
omusajja	o m u s a j j a
wabula	w a b u l a
obusookera	o b u s o o k e r a
obulungi	o b u l u n g i
omuwendo	o m u w e n d o
enfaanana	e n f a a n a n a
lya	l y a
bizimbisibwa	b i z i m b i s i b w a
yagambibwa	y a g a m b i b w a
tukuleetedde	t u k u l e e t e d d e
ssente	s s e n t e
olina	o l i n a
bakazi	b a k a z i
emirundi	e m i r u n d i
wampimira	w a m p i m i r a
alowooza	a l o w o o z a
essomero	e s s o m e r o
ku	k u
lyomusujja	l y o m u s u j j a
emmeeme	e m m e e m e
y’asooka	y ’ a s o o k a
buvunaanyizibwa	b u v u n a a n y i z i b w a
kulonda	k u l o n d a
asimbibwa	a s i m b i b w a
buli	b u l i
okwambala	o k w a m b a l a
butuufu	b u t u u f u
ebikolwa	e b i k o l w a
amaduuka	a m a d u u k a
kibuga	k i b u g a
atukubiriza	a t u k u b i r i z a
abangi	a b a n g i
okusaasaana	o k u s a a s a a n a
okuyita	o k u y i t a
obwa	o b w a
oyige	o y i g e
nga	n g a
abamu	a b a m u
akazannyo	a k a z a n n y o
baki	b a k i
kuzimba	k u z i m b a
byabbiddwa	b y a b b i d d w a
kwabwe	k w a b w e
namuli	n a m u l i
siringi	s i r i n g i
atuula	a t u u l a
babendako	b a b e n d a k o
byobulimi	b y o b u l i m i
okukikozesa	o k u k i k o z e s a
ebyobutujju	e b y o b u t u j j u
abafa	a b a f a
ebigezo	e b i g e z o
faayo	f a a y o
agira	a g i r a
eziggyayo	e z i g g y a y o
nobubbi	n o b u b b i
omperekereko	o m p e r e k e r e k o
ko	k o
teweesiga	t e w e e s i g a
baabwe	b a a b w e
biyamba	b i y a m b a
bisobola	b i s o b o l a
gw’ekika	g w ’ e k i k a
okukozesa	o k u k o z e s a
nendwadde	n e n d w a d d e
bimenya	b i m e n y a
lwomwana	l w o m w a n a
litunda	l i t u n d a
kawempe	k a w e m p e
oguwedde	o g u w e d d e
gulina	g u l i n a
emiganyulo	e m i g a n y u l o
baalyekanze	b a a l y e k a n z e
ebirala	e b i r a l a
lyengoye	l y e n g o y e
tayinza	t a y i n z a
gyogyagalamu	g y o g y a g a l a m u
nsuubira	n s u u b i r a
olugezigezi	o l u g e z i g e z i
obujjanjabi	o b u j j a n j a b i
lukiiko	l u k i i k o
zaali	z a a l i
enkonge	e n k o n g e
ayagala	a y a g a l a
looni	l o o n i
eriri	e r i r i
nnyonnyola	n n y o n n y o l a
kirumira	k i r u m i r a
nti	n t i
abiri	a b i r i
agakumala	a g a k u m a l a
okimanyi	o k i m a n y i
yavunaaniddwa	y a v u n a a n i d d w a
bimuzza	b i m u z z a
oyo	o y o
kye	k y e
bwe	b w e
embeera	e m b e e r a
munnabusiro	m u n n a b u s i r o
olwo	o l w o
kavuddemu	k a v u d d e m u
njeru	n j e r u
azannye	a z a n n y e
omuswaki	o m u s w a k i
tegabaamu	t e g a b a a m u
gano	g a n o
naye	n a y e
geddagala	g e d d a g a l a
n’addirirwa	n ’ a d d i r i r w a
ne	n e
kya	k y a
wedduuka	w e d d u u k a
kaseera	k a s e e r a
muwogo	m u w o g o
oba	o b a
baana	b a a n a
mukazi	m u k a z i
bwekuluma	b w e k u l u m a
omulundi	o m u l u n d i
abayizi	a b a y i z i
nkulamusizza	n k u l a m u s i z z a
omu	o m u
okusinziira	o k u s i n z i i r a
galina	g a l i n a
omuwala	o m u w a l a
obuyinza	o b u y i n z a
gavumenti	g a v u m e n t i
ebbali	e b b a l i
nokuzaala	n o k u z a a l a
londako	l o n d a k o
bo	b o
ziteeka	z i t e e k a
gava	g a v a
batandise	b a t a n d i s e
omuswaki	o m u s w a k i
yange	y a n g e
bokulembera	b o k u l e m b e r a
ebipande	e b i p a n d e
beebo	b e e b o
omuzannyi	o m u z a n n y i
kyabwe	k y a b w e
okuziyizamu	o k u z i y i z a m u
ssaalumanya	s s a a l u m a n y a
edduuka	e d d u u k a
kirudde	k i r u d d e
ennyumba	e n n y u m b a
ebiragiro	e b i r a g i r o
ebibinja	e b i b i n j a
omukulu	o m u k u l u
kiseera	k i s e e r a
bya	b y a
bulungi	b u l u n g i
mingi	m i n g i
mmeka	m m e k a
beenyigira	b e e n y i g i r a
esatu	e s a t u
ekifo	e k i f o
gw’abaana	g w ’ a b a a n a
alipoota	a l i p o o t a
omuntu	o m u n t u
we	w e
ezambaddwamu	e z a m b a d d w a m u
yali	y a l i
zino	z i n o
boludda	b o l u d d a
omuzannyo	o m u z a n n y o
bbugwe	b b u g w e
mboozi	m b o o z i
okugula	o k u g u l a
dduuka	d d u u k a
okuyingira	o k u y i n g i r a
ekiteeso	e k i t e e s o
bye	b y e
konsitityusoni	k o n s i t i t y u s o n i
kye	k y e
siwummula	s i w u m m u l a
kyekisanja	k y e k i s a n j a
nsonga	n s o n g a
kkubo	k k u b o
okwogeramu	o k w o g e r a m u
bulungi	b u l u n g i
eryomu	e r y o m u
yeetaba	y e e t a b a
abanafu	a b a n a f u
yabadde	y a b a d d e
ekirwadde	e k i r w a d d e
ttano	t t a n o
okuva	o k u v a
empya	e m p y a
njambalirawo	n j a m b a l i r a w o
babuuzizza	b a b u u z i z z a
ogwokuva	o g w o k u v a
ako	a k o
ani	a n i
lubuto	l u b u t o
ekitone	e k i t o n e
mulyango	m u l y a n g o
ebirango	e b i r a n g o
banoonyerereza	b a n o o n y e r e r e z a
eryobwebange	e r y o b w e b a n g e
tebalina	t e b a l i n a
okuwangula	o k u w a n g u l a
lwa	l w a
ekitabo	e k i t a b o
embwa	e m b w a
gyasigazza	g y a s i g a z z a
okulwana	o k u l w a n a
entebe	e n t e b e
osaana	o s a a n a
nabalala	n a b a l a l a
nkwaso	n k w a s o
wakamunye	w a k a m u n y e
okugikozesa	o k u g i k o z e s a
naawe	n a a w e
tumumma	t u m u m m a
okumpi	o k u m p i
okugyoza	o k u g y o z a
agoomunda	a g o o m u n d a
tebikyasomebwa	t e b i k y a s o m e b w a
kukola	k u k o l a
okwesigamya	o k w e s i g a m y a
jjangu	j j a n g u
wa	w a
tebyawera	t e b y a w e r a
omukambwe	o m u k a m b w e
tayagala	t a y a g a l a
gw’ozaaala	g w ’ o z a a a l a
gulwayo	g u l w a y o
abalongoosa	a b a l o n g o o s a
olulimi	o l u l i m i
obulabe	o b u l a b e
namulaba	n a m u l a b a
tegeeza	t e g e e z a
kyokuzina	k y o k u z i n a
byomujjuzo	b y o m u j j u z o
kibuga	k i b u g a
zituuse	z i t u u s e
limu	l i m u
okusomesa	o k u s o m e s a
kuzaalibwa	k u z a a l i b w a
y’omulundi	y ’ o m u l u n d i
omuvubuka	o m u v u b u k a
eggwanga	e g g w a n g a
yabitwalanga	y a b i t w a l a n g a
kuleetera	k u l e e t e r a
guno	g u n o
akakuubagano	a k a k u u b a g a n o
mwagala	m w a g a l a
kusooka	k u s o o k a
abamuddako	a b a m u d d a k o
ezeetagisa	e z e e t a g i s a
eyakoze	e y a k o z e
bwamala	b w a m a l a
kusoboka	k u s o b o k a
nakolera	n a k o l e r a
ate	a t e
bbaasi	b b a a s i
ago	a g o
taliyo	t a l i y o
mukozi	m u k o z i
yeetegese	y e e t e g e s e
okutikkirwa	o k u t i k k i r w a
bwammwe	b w a m m w e
okubeera	o k u b e e r a
abaana	a b a a n a
byokuziika	b y o k u z i i k a
omwami	o m w a m i
eyali	e y a l i
gwa	g w a
amateeka	a m a t e e k a
nnyo	n n y o
ozikozese	o z i k o z e s e
tagoberedde	t a g o b e r e d d e
mwekuumenga	m w e k u u m e n g a
mpozzi	m p o z z i
bitono	b i t o n o
amadduuka	a m a d d u u k a
yanteeka	y a n t e e k a
wakati	w a k a t i
ebyavudde	e b y a v u d d e
kyokuzimba	k y o k u z i m b a
nsi	n s i
yazaalibwa	y a z a a l i b w a
erimu	e r i m u
abasajja	a b a s a j j a
omwana	o m w a n a
akaya	a k a y a
yatwala	y a t w a l a
ca	c a
ddembe	d d e m b e
lungi	l u n g i
omusaala	o m u s a a l a
atabisomye	a t a b i s o m y e
ngeri	n g e r i
amazzi	a m a z z i
engeri	e n g e r i
ekibadde	e k i b a d d e
konna	k o n n a
wakati	w a k a t i
bazitereka	b a z i t e r e k a
luggya	l u g g y a
nnina	n n i n a
munnange	m u n n a n g e
ebigaaniddwa	e b i g a a n i d d w a
okuggala	o k u g g a l a
ba	b a
mukuba	m u k u b a
teyebalirira	t e y e b a l i r i r a
kapital	k a p i t a l
omusomesa	o m u s o m e s a
abakyala	a b a k y a l a
gyetuyinza	g y e t u y i n z a
abantu	a b a n t u
basasulwa	b a s a s u l w a
okutangira	o k u t a n g i r a
embiriizi	e m b i r i i z i
ebirungi	e b i r u n g i
okutuuka	o k u t u u k a
enguzi	e n g u z i
abaganyuzi	a b a g a n y u z i
ccakalacakala	c c a k a l a c a k a l a
singa	s i n g a
bw	b w
ago	a g o
kujja	k u j j a
okukirizza	o k u k i r i z z a
abalimi	a b a l i m i
ebyobulamu	e b y o b u l a m u
ebitabo	e b i t a b o
gatunda	g a t u n d a
okujulira	o k u j u l i r a
amakulu	a m a k u l u
yamuwa	y a m u w a
okugulwa	o k u g u l w a
ki	k i
nnyo	n n y o
obwo	o b w o
emyaka	e m y a k a
ennyo	e n n y o
dduuka	d d u u k a
ebeera	e b e e r a
nakawangula	n a k a w a n g u l a
likaawa	l i k a a w a
agamba	a g a m b a
mu	m u
mulimu	m u l i m u
kibadde	k i b a d d e
ogenda	o g e n d a
okuziyiza	o k u z i y i z a
abo	a b o
abali	a b a l i
omukazi	o m u k a z i
tegasobola	t e g a s o b o l a
abajulizi	a b a j u l i z i
oli	o l i
guvuga	g u v u g a
engoye	e n g o y e
ssomero	s s o m e r o
kye	k y e
boogera	b o o g e r a
nabuuka	n a b u u k a
mangu	m a n g u
byamuddamu	b y a m u d d a m u
ka	k a
kyakulya	k y a k u l y a
ye	y e
omukazi	o m u k a z i
kakunyumidde	k a k u n y u m i d d e
wamadduuka	w a m a d d u u k a
gwabasawo	g w a b a s a w o
yatuweereza	y a t u w e e r e z a
kubeera	k u b e e r a
zandikendeezezza	z a n d i k e n d e e z e z z a
gomesi	g o m e s i
okuyombera	o k u y o m b e r a
mubala	m u b a l a
ayitiwo	a y i t i w o
awe	a w e
bambi	b a m b i
obulungi	o b u l u n g i
katikkiro	k a t i k k i r o
kingi	k i n g i
akalango	a k a l a n g o
ebalese	e b a l e s e
wessomero	w e s s o m e r o
tweyagalidde	t w e y a g a l i d d e
n’amuwa	n ’ a m u w a
lyabaana	l y a b a a n a
olumala	o l u m a l a
nja	n j a
bwabwe	b w a b w e
yo	y o
amateeka	a m a t e e k a
kundagirira	k u n d a g i r i r a
olubiri	o l u b i r i
abalwadde	a b a l w a d d e
bakusobera	b a k u s o b e r a
twakola	t w a k o l a
ebbanga	e b b a n g a
omutunzi	o m u t u n z i
yasookera	y a s o o k e r a
lw’awulira	l w ’ a w u l i r a
tekirina	t e k i r i n a
okuwona	o k u w o n a
ababeera	a b a b e e r a
bandibadde	b a n d i b a d d e
kufuna	k u f u n a
nsaba	n s a b a
ngabantu	n g a b a n t u
gaba	g a b a
omukyala	o m u k y a l a
olwakola	o l w a k o l a
muwandiikiragana	m u w a n d i i k i r a g a n a
bali	b a l i
bategekeddwa	b a t e g e k e d d w a
mutono	m u t o n o
abaami	a b a a m i
mbeera	m b e e r a
egaanye	e g a a n y e
akawuka	a k a w u k a
lwaki	l w a k i
abatwalira	a b a t w a l i r a
bulemenga	b u l e m e n g a
okukubisibwamu	o k u k u b i s i b w a m u
kivunaanyibwa	k i v u n a a n y i b w a
munno	m u n n o
yaggulawo	y a g g u l a w o
gaggalawo	g a g g a l a w o
ekyomukisa	e k y o m u k i s a
oluganda	o l u g a n d a
amagye	a m a g y e
kwe	k w e
b’osobola	b ’ o s o b o l a
okwewalibwa	o k w e w a l i b w a
mwanjo	m w a n j o
abaaleeta	a b a a l e e t a
nabo	n a b o
bakambwe	b a k a m b w e
kkumi	k k u m i
banjagala	b a n j a g a l a
amawulire	a m a w u l i r e
lukumi	l u k u m i
liriwa	l i r i w a
kijjudde	k i j j u d d e
kyabazinga	k y a b a z i n g a
okuba	o k u b a
obukulu	o b u k u l u
be	b e
engoye	e n g o y e
gasiima	g a s i i m a
yagaana	y a g a a n a
bantu	b a n t u
wange	w a n g e
kufumbirwa	k u f u m b i r w a
lino	l i n o
zonna	z o n n a
biseera	b i s e e r a
yaleeta	y a l e e t a
ssenyiga	s s e n y i g a
kunoonyereza	k u n o o n y e r e z a
okuddamu	o k u d d a m u
okuvuganya	o k u v u g a n y a
omusujja	o m u s u j j a
obulwadde	o b u l w a d d e
okubaako	o k u b a a k o
teyozebwa	t e y o z e b w a
birina	b i r i n a
asinga	a s i n g a
emmotoka	e m m o t o k a
munne	m u n n e
gye	g y e
layisinsi	l a y i s i n s i
simulaba	s i m u l a b a
yansanyusa	y a n s a n y u s a
liba	l i b a
nkulabe	n k u l a b e
okuboggola	o k u b o g g o l a
gakola	g a k o l a
enkya	e n k y a
eri	e r i
okusoma	o k u s o m a
ebiwuka	e b i w u k a
balagajjalirwa	b a l a g a j j a l i r w a
kubanga	k u b a n g a
eddagala	e d d a g a l a
by’okuzaala	b y ’ o k u z a a l a
mbuto	m b u t o
sheelo	s h e e l o
mirimu	m i r i m u
tegeka	t e g e k a
atunda	a t u n d a
bakola	b a k o l a
lye	l y e
ekitongole	e k i t o n g o l e
muganda	m u g a n d a
abasomesa	a b a s o m e s a
omubaka	o m u b a k a
tasaanye	t a s a a n y e
bino	b i n o
basobola	b a s o b o l a
okubuulira	o k u b u u l i r a
tutandika	t u t a n d i k a
bwagambako	b w a g a m b a k o
abasirikirwa	a b a s i r i k i r w a
gyonna	g y o n n a
nasaba	n a s a b a
ngalo	n g a l o
ebitabo	e b i t a b o
ngagoba	n g a g o b a
yenna	y e n n a
yobubakko	y o b u b a k k o
kyetaagisa	k y e t a a g i s a
baakumujjukiranga	b a a k u m u j j u k i r a n g a
kitubala	k i t u b a l a
kitundu	k i t u n d u
webuli	w e b u l i
agatunda	a g a t u n d a
maduuka	m a d u u k a
