waya	w a y a
omperekereko	o m p e r e k e r e k o
amaziga	a m a z i g a
ogenda	o g e n d a
maaso	m a a s o
mboozi	m b o o z i
ewaka	e w a k a
baweereddwa	b a w e e r e d d w a
okwegomba	o k w e g o m b a
munaana	m u n a a n a
naziggya	n a z i g g y a
asangiddwa	a s a n g i d d w a
abadde	a b a d d e
tebikyasomebwa	t e b i k y a s o m e b w a
ngotambula	n g o t a m b u l a
ekinyuma	e k i n y u m a
kkojjaawe	k k o j j a a w e
kibuga	k i b u g a
ejjambiya	e j j a m b i y a
yaleeta	y a l e e t a
banjagala	b a n j a g a l a
olwokwewaayo	o l w o k w e w a a y o
olwo	o l w o
tezimala	t e z i m a l a
keegugungo	k e e g u g u n g o
katagaza	k a t a g a z a
okwongera	o k w o n g e r a
birowoozo	b i r o w o o z o
yayongerako	y a y o n g e r a k o
ebipya	e b i p y a
ezessimba	e z e s s i m b a
azannya	a z a n n y a
nabebibiina	n a b e b i b i i n a
bo	b o
gyonna	g y o n n a
zizaala	z i z a a l a
kyayi	k y a y i
bakakiiko	b a k a k i i k o
ssaala	s s a a l a
okulwanagana	o k u l w a n a g a n a
abalina	a b a l i n a
okwetooloola	o k w e t o o l o o l a
okusasula	o k u s a s u l a
babendako	b a b e n d a k o
kubaawo	k u b a a w o
gokunywa	g o k u n y w a
okkukolera	o k k u k o l e r a
nsanikiddwa	n s a n i k i d d w a
beebo	b e e b o
yobubakko	y o b u b a k k o
buntu	b u n t u
teweesiize	t e w e e s i i z e
ezakawuka	e z a k a w u k a
ba	b a
basobola	b a s o b o l a
okuddamu	o k u d d a m u
byebyafaayo	b y e b y a f a a y o
ye	y e
z’ennimi	z ’ e n n i m i
ngeri	n g e r i
ekiro	e k i r o
wabanoonyi	w a b a n o o n y i
nobwenkanya	n o b w e n k a n y a
ngomukulembeze	n g o m u k u l e m b e z e
yakubiddwa	y a k u b i d d w a
talidde	t a l i d d e
atabisomye	a t a b i s o m y e
yantegeeza	y a n t e g e e z a
kwewola	k w e w o l a
erina	e r i n a
wetuuse	w e t u u s e
nabyo	n a b y o
tebakirizibwa	t e b a k i r i z i b w a
bazadde	b a z a d d e
kukyaza	k u k y a z a
boluswayiri	b o l u s w a y i r i
bulemesa	b u l e m e s a
gwokka	g w o k k a
bujjuvu	b u j j u v u
nti	n t i
amasasi	a m a s a s i
biteekwa	b i t e e k w a
olowooza	o l o w o o z a
obuyonjo	o b u y o n j o
kwogeraganya	k w o g e r a g a n y a
bwetali	b w e t a l i
okwekuuma	o k w e k u u m a
ekinusu	e k i n u s u
olwokukwata	o l w o k u k w a t a
kubanga	k u b a n g a
waleme	w a l e m e
ogusinga	o g u s i n g a
gavumenti	g a v u m e n t i
wabaserikale	w a b a s e r i k a l e
bakozesa	b a k o z e s a
baabwe	b a a b w e
abasajja	a b a s a j j a
namuli	n a m u l i
abasinga	a b a s i n g a
alowooza	a l o w o o z a
lweggwanga	l w e g g w a n g a
namugamba	n a m u g a m b a
gaba	g a b a
munne	m u n n e
tabaaga	t a b a a g a
gwebintu	g w e b i n t u
kwonna	k w o n n a
buweereza	b u w e e r e z a
mubala	m u b a l a
kwesiga	k w e s i g a
ozikozese	o z i k o z e s e
ffenna	f f e n n a
yatuweereza	y a t u w e e r e z a
ezimu	e z i m u
alemererwe	a l e m e r e r w e
mbadde	m b a d d e
lukwe	l u k w e
nattidde	n a t t i d d e
kukusanyusa	k u k u s a n y u s a
kubunyisa	k u b u n y i s a
poliisi	p o l i i s i
okwerabira	o k w e r a b i r a
tegalimu	t e g a l i m u
olukiiko	o l u k i i k o
nabbosa	n a b b o s a
wemyaka	w e m y a k a
lyebisolo	l y e b i s o l o
amanyi	a m a n y i
misango	m i s a n g o
ebisomesebwa	e b i s o m e s e b w a
noolwekyo	n o o l w e k y o
lubuto	l u b u t o
bajja	b a j j a
omu	o m u
kwakawuka	k w a k a w u k a
waalyo	w a a l y o
byobulimi	b y o b u l i m i
eyeebase	e y e e b a s e
bunyuma	b u n y u m a
bututandise	b u t u t a n d i s e
ensaamusaamu	e n s a a m u s a a m u
nfuna	n f u n a
ngabalala	n g a b a l a l a
kimenya	k i m e n y a
mungeri	m u n g e r i
nsanyufu	n s a n y u f u
ate	a t e
nakatundutundu	n a k a t u n d u t u n d u
okumuyamba	o k u m u y a m b a
okubaawo	o k u b a a w o
baggya	b a g g y a
ekiraamo	e k i r a a m o
okutiisatiisa	o k u t i i s a t i i s a
bawala	b a w a l a
okwagalibwa	o k w a g a l i b w a
bwova	b w o v a
yokumulirwano	y o k u m u l i r w a n o
gugenda	g u g e n d a
okuvuvungana	o k u v u v u n g a n a
kinkontana	k i n k o n t a n a
betaaga	b e t a a g a
ogwokusatu	o g w o k u s a t u
ategeezezza	a t e g e e z e z z a
nti	n t i
munnange	m u n n a n g e
bw’obutiti	b w ’ o b u t i t i
ggwanga	g g w a n g a
kiragiro	k i r a g i r o
n’enteekerateekera	n ’ e n t e e k e r a t e e k e r a
bavubuka	b a v u b u k a
bamutuma	b a m u t u m a
ali	a l i
lyabantu	l y a b a n t u
bazannyira	b a z a n n y i r a
atuula	a t u u l a
beetegefu	b e e t e g e f u
sikaala	s i k a a l a
omusogozi	o m u s o g o z i
semina	s e m i n a
ssaabaminisita	s s a a b a m i n i s i t a
okuliisibwa	o k u l i i s i b w a
anaatera	a n a a t e r a
ensaamusaamu	e n s a a m u s a a m u
abaagalwa	a b a a g a l w a
nettaka	n e t t a k a
maaso	m a a s o
yavunaaniddwa	y a v u n a a n i d d w a
kumalamu	k u m a l a m u
omusirikale	o m u s i r i k a l e
togezaako	t o g e z a a k o
ke	k e
ngabasomesa	n g a b a s o m e s a
lyaffe	l y a f f e
ateekeddwa	a t e e k e d d w a
okugaba	o k u g a b a
busuulu	b u s u u l u
kulungi	k u l u n g i
ago	a g o
ebbali	e b b a l i
okukeberebwa	o k u k e b e r e b w a
obunyama	o b u n y a m a
ekiyitibwa	e k i y i t i b w a
nsaba	n s a b a
ekikoola	e k i k o o l a
kizibwe	k i z i b w e
ngava	n g a v a
nabiryo	n a b i r y o
ekibonerezo	e k i b o n e r e z o
bwamufuula	b w a m u f u u l a
emigattabantu	e m i g a t t a b a n t u
leero	l e e r o
guvuga	g u v u g a
kivunaanyibwa	k i v u n a a n y i b w a
abaami	a b a a m i
ku	k u
ebikwekweto	e b i k w e k w e t o
enkyukakyuka	e n k y u k a k y u k a
bw’ensi	b w ’ e n s i
okufuna	o k u f u n a
kumalawo	k u m a l a w o
biweze	b i w e z e
akyalire	a k y a l i r e
bafuna	b a f u n a
essanyu	e s s a n y u
eyimiridde	e y i m i r i d d e
ebyenjawulo	e b y e n j a w u l o
yobukaba	y o b u k a b a
olwafulumiziddwa	o l w a f u l u m i z i d d w a
emiganyulo	e m i g a n y u l o
akafaananyi	a k a f a a n a n y i
okulangibwa	o k u l a n g i b w a
kitya	k i t y a
okufa	o k u f a
kisaana	k i s a a n a
olwaleero	o l w a l e e r o
abambuuzizza	a b a m b u u z i z z a
kavuddemu	k a v u d d e m u
abbey	a b b e y
nokuba	n o k u b a
biramu	b i r a m u
obukiikakkono	o b u k i i k a k k o n o
bayita	b a y i t a
yemirimu	y e m i r i m u
yenjuki	y e n j u k i
omukebe	o m u k e b e
neddoboozi	n e d d o b o o z i
nneeraliikirizza	n n e e r a l i i k i r i z z a
gaalondebwa	g a a l o n d e b w a
abali	a b a l i
efunye	e f u n y e
emugobye	e m u g o b y e
zaabwe	z a a b w e
basuubirwa	b a s u u b i r w a
pulayimale	p u l a y i m a l e
bavaayo	b a v a a y o
ssaayansi	s s a a y a n s i
buzibu	b u z i b u
tumenyereyo	t u m e n y e r e y o
gujja	g u j j a
gyetuyinza	g y e t u y i n z a
beekwasa	b e e k w a s a
eziyingira	e z i y i n g i r a
butuyambye	b u t u y a m b y e
okubayambako	o k u b a y a m b a k o
ebigezo	e b i g e z o
twabadde	t w a b a d d e
bwaweddewo	b w a w e d d e w o
nobutabanguko	n o b u t a b a n g u k o
enkola	e n k o l a
mulungi	m u l u n g i
byensi	b y e n s i
eddungi	e d d u n g i
sijjukira	s i j j u k i r a
abakwatiddwa	a b a k w a t i d d w a
munnange	m u n n a n g e
bwekuluma	b w e k u l u m a
bwammwe	b w a m m w e
twafunangayo	t w a f u n a n g a y o
ngenda	n g e n d a
mu	m u
okutereeza	o k u t e r e e z a
kyenda	k y e n d a
ssennyiga	s s e n n y i g a
atutte	a t u t t e
abiri	a b i r i
matono	m a t o n o
obupunta	o b u p u n t a
teweesiga	t e w e e s i g a
okusala	o k u s a l a
mwakubidde	m w a k u b i d d e
kufulumizibwa	k u f u l u m i z i b w a
disitulikiti	d i s i t u l i k i t i
ebbaluwa	e b b a l u w a
nebyokukola	n e b y o k u k o l a
yalabikiddeko	y a l a b i k i d d e k o
abakulu	a b a k u l u
eggwanga	e g g w a n g a
baasenguka	b a a s e n g u k a
abakazi	a b a k a z i
booda	b o o d a
otya	o t y a
kifo	k i f o
abayeekera	a b a y e e k e r a
katikkiro	k a t i k k i r o
obuyambi	o b u y a m b i
womukulembeze	w o m u k u l e m b e z e
omukozi	o m u k o z i
yatwala	y a t w a l a
amanene	a m a n e n e
gwali	g w a l i
abebyokwerinda	a b e b y o k w e r i n d a
omuyembe	o m u y e m b e
osanga	o s a n g a
ebipya	e b i p y a
waaliwo	w a a l i w o
bantu	b a n t u
ebyobugagga	e b y o b u g a g g a
buno	b u n o
wayagalira	w a y a g a l i r a
tezikyajja	t e z i k y a j j a
byolina	b y o l i n a
tewaliyo	t e w a l i y o
ebyavudde	e b y a v u d d e
abaaliko	a b a a l i k o
weggwanga	w e g g w a n g a
ebisinga	e b i s i n g a
kwewala	k w e w a l a
ekipande	e k i p a n d e
magoba	m a g o b a
bannansi	b a n n a n s i
namaliba	n a m a l i b a
mulundi	m u l u n d i
yamulagira	y a m u l a g i r a
tujja	t u j j a
obadde	o b a d d e
basigadde	b a s i g a d d e
okutekamu	o k u t e k a m u
okuwaayo	o k u w a a y o
ssente	s s e n t e
omusirikale	o m u s i r i k a l e
esomerwamu	e s o m e r w a m u
alina	a l i n a
byakoledde	b y a k o l e d d e
bulumya	b u l u m y a
basattira	b a s a t t i r a
ebyamaguzi	e b y a m a g u z i
okutuula	o k u t u u l a
okuwangula	o k u w a n g u l a
mikwano	m i k w a n o
obuzitawaanya	o b u z i t a w a a n y a
ebitundu	e b i t u n d u
egiri	e g i r i
lwabakyala	l w a b a k y a l a
kabona	k a b o n a
tegabaamu	t e g a b a a m u
bungi	b u n g i
omusiike	o m u s i i k e
wenkiiko	w e n k i i k o
zabavuganya	z a b a v u g a n y a
okugaana	o k u g a a n a
abakalamojja	a b a k a l a m o j j a
muzannyo	m u z a n n y o
bwenguzi	b w e n g u z i
obulumi	o b u l u m i
bataataaganya	b a t a a t a a g a n y a
tosaanidde	t o s a a n i d d e
okugoba	o k u g o b a
emigumu	e m i g u m u
toyomba	t o y o m b a
asikiriza	a s i k i r i z a
bwaba	b w a b a
ekisaawe	e k i s a a w e
zo	z o
ekiranga	e k i r a n g a
abo	a b o
abaganyuzi	a b a g a n y u z i
bali	b a l i
ekusuuza	e k u s u u z a
kukulaakulana	k u k u l a a k u l a n a
abazaala	a b a z a a l a
lwaki	l w a k i
ezitukula	e z i t u k u l a
emirimu	e m i r i m u
okukyenyigiramu	o k u k y e n y i g i r a m u
osaana	o s a a n a
teesa	t e e s a
bwangu	b w a n g u
kuzzaamu	k u z z a a m u
eggulo	e g g u l o
obulungi	o b u l u n g i
limu	l i m u
mawuggwe	m a w u g g w e
etaddewo	e t a d d e w o
yakyusibwa	y a k y u s i b w a
kampuni	k a m p u n i
byamuddamu	b y a m u d d a m u
beenyigira	b e e n y i g i r a
kimuggyako	k i m u g g y a k o
ebiteekeddwa	e b i t e e k e d d w a
boku	b o k u
buli	b u l i
ekinene	e k i n e n e
abalala	a b a l a l a
otegeera	o t e g e e r a
b’osobola	b ’ o s o b o l a
abalwadde	a b a l w a d d e
kusasula	k u s a s u l a
namugongo	n a m u g o n g o
okukomolebwa	o k u k o m o l e b w a
ennyingi	e n n y i n g i
omuto	o m u t o
wa	w a
okuziyizamu	o k u z i y i z a m u
amatooke	a m a t o o k e
busirisi	b u s i r i s i
mutwe	m u t w e
omwesibyeko	o m w e s i b y e k o
zamazzi	z a m a z z i
kyekisanja	k y e k i s a n j a
okufuuka	o k u f u u k a
yabaana	y a b a a n a
tegyagala	t e g y a g a l a
mugenda	m u g e n d a
wano	w a n o
mwaka	m w a k a
ssowani	s s o w a n i
byayo	b y a y o
obuveera	o b u v e e r a
muko	m u k o
ezimba	e z i m b a
muwogo	m u w o g o
amateeka	a m a t e e k a
bennyimba	b e n n y i m b a
nebinyeebwa	n e b i n y e e b w a
kasasiro	k a s a s i r o
omwami	o m w a m i
basobole	b a s o b o l e
mungi	m u n g i
kyolina	k y o l i n a
baagenti	b a a g e n t i
okugema	o k u g e m a
ebbanga	e b b a n g a
esatu	e s a t u
mwana	m w a n a
ssaagala	s s a a g a l a
tebafunye	t e b a f u n y e
oluvuganya	o l u v u g a n y a
yategezezza	y a t e g e z e z z a
kuteekeddwa	k u t e e k e d d w a
oyige	o y i g e
miti	m i t i
nduli	n d u l i
egyennaku	e g y e n n a k u
bimenya	b i m e n y a
gi	g i
byokubaluka	b y o k u b a l u k a
abato	a b a t o
akaguwa	a k a g u w a
omwerufu	o m w e r u f u
myaka	m y a k a
obuseere	o b u s e e r e
kulya	k u l y a
okubuulira	o k u b u u l i r a
kaabuze	k a a b u z e
egiteeke	e g i t e e k e
okubayimbula	o k u b a y i m b u l a
ayitidde	a y i t i d d e
kw’otadde	k w ’ o t a d d e
omutamiivu	o m u t a m i i v u
nakolera	n a k o l e r a
kirowoozo	k i r o w o o z o
enguzi	e n g u z i
kusaanyawo	k u s a a n y a w o
bikolebwa	b i k o l e b w a
ebijanjaalo	e b i j a n j a a l o
avunaanyizibwa	a v u n a a n y i z i b w a
nomu	n o m u
kyakuyigiriza	k y a k u y i g i r i z a
matono	m a t o n o
egyenkanankana	e g y e n k a n a n k a n a
eba	e b a
omukama	o m u k a m a
ekyemyaka	e k y e m y a k a
kikulu	k i k u l u
okukomyawo	o k u k o m y a w o
ebiri	e b i r i
gyo	g y o
endiirwa	e n d i i r w a
awaka	a w a k a
looni	l o o n i
ekyalo	e k y a l o
emu	e m u
amagombolola	a m a g o m b o l o l a
n’eddoboozi	n ’ e d d o b o o z i
gavumenti	g a v u m e n t i
konna	k o n n a
bayanirizibwa	b a y a n i r i z i b w a
emiggo	e m i g g o
muntu	m u n t u
kuzimba	k u z i m b a
bakazi	b a k a z i
bangi	b a n g i
muyanja	m u y a n j a
okulekulira	o k u l e k u l i r a
saagala	s a a g a l a
towulira	t o w u l i r a
zituuse	z i t u u s e
okwesigamya	o k w e s i g a m y a
ayambala	a y a m b a l a
tebalina	t e b a l i n a
tebafunangako	t e b a f u n a n g a k o
obululu	o b u l u l u
mulala	m u l a l a
kkanisa	k k a n i s a
obutagoberera	o b u t a g o b e r e r a
batondawo	b a t o n d a w o
ebigezo	e b i g e z o
mwanjo	m w a n j o
okukula	o k u k u l a
otunula	o t u n u l a
amaanyi	a m a a n y i
gyokwanjula	g y o k w a n j u l a
ttooyi	t t o o y i
omusujja	o m u s u j j a
bwoba	b w o b a
gaggyibwa	g a g g y i b w a
enkulu	e n k u l u
ova	o v a
ng’ekimu	n g ’ e k i m u
baabwe	b a a b w e
eribaweereddwa	e r i b a w e e r e d d w a
we	w e
balitandika	b a l i t a n d i k a
mirundi	m i r u n d i
omupiira	o m u p i i r a
kimaanya	k i m a a n y a
bbanka	b b a n k a
mukiibi	m u k i i b i
gwokuzimba	g w o k u z i m b a
abaliyo	a b a l i y o
ebibiina	e b i b i i n a
nebifo	n e b i f o
byamawulire	b y a m a w u l i r e
yavaayo	y a v a a y o
busatu	b u s a t u
ebizibu	e b i z i b u
okusaasaana	o k u s a a s a a n a
okuwagira	o k u w a g i r a
okubifunamu	o k u b i f u n a m u
okulayira	o k u l a y i r a
ngenkulu	n g e n k u l u
tali	t a l i
waakiri	w a a k i r i
bwensimbi	b w e n s i m b i
baminisita	b a m i n i s i t a
mutabani	m u t a b a n i
	
ngalina	n g a l i n a
byabanoonyi	b y a b a n o o n y i
emugga	e m u g g a
bafa	b a f a
kkumi	k k u m i
birina	b i r i n a
okusomera	o k u s o m e r a
ogwenkana	o g w e n k a n a
beetaga	b e e t a g a
erinnya	e r i n n y a
zokuleeta	z o k u l e e t a
by’okuzaala	b y ’ o k u z a a l a
obulindaala	o b u l i n d a a l a
kwambala	k w a m b a l a
aggyayo	a g g y a y o
zikola	z i k o l a
lule	l u l e
okusonyiyibwa	o k u s o n y i y i b w a
okutunda	o k u t u n d a
bentebbe	b e n t e b b e
ebyuma	e b y u m a
womukulu	w o m u k u l u
africa	a f r i c a
engassi	e n g a s s i
lyomusujja	l y o m u s u j j a
engulu	e n g u l u
ereeta	e r e e t a
ategeera	a t e g e e r a
ssaawa	s s a a w a
kugwa	k u g w a
obukookolo	o b u k o o k o l o
ssetendekero	s s e t e n d e k e r o
mwekuumenga	m w e k u u m e n g a
obwa	o b w a
tugende	t u g e n d e
okulowooza	o k u l o w o o z a
kisa	k i s a
baani	b a a n i
ababbi	a b a b b i
ebiseera	e b i s e e r a
okusimattuka	o k u s i m a t t u k a
ekyo	e k y o
akawuka	a k a w u k a
yagaana	y a g a a n a
kukotoggera	k u k o t o g g e r a
oluguudo	o l u g u u d o
mbidde	m b i d d e
ezeetagisa	e z e e t a g i s a
genjuba	g e n j u b a
akaagudde	a k a a g u d d e
siyinza	s i y i n z a
bakadde	b a k a d d e
kwali	k w a l i
twakola	t w a k o l a
baamuwa	b a a m u w a
kulonda	k u l o n d a
kaweefube	k a w e e f u b e
kyolowooza	k y o l o w o o z a
olwebeeya	o l w e b e e y a
masiki	m a s i k i
twewuunyizza	t w e w u u n y i z z a
kwabaneetaba	k w a b a n e e t a b a
okulwana	o k u l w a n a
okwekikungo	o k w e k i k u n g o
bisuubizo	b i s u u b i z o
byaffe	b y a f f e
pulogulamu	p u l o g u l a m u
kamu	k a m u
buvunaanyizibwa	b u v u n a a n y i z i b w a
amalirize	a m a l i r i z e
yanjulwa	y a n j u l w a
gwatwalibwa	g w a t w a l i b w a
ogwakutte	o g w a k u t t e
zokka	z o k k a
bakulu	b a k u l u
ndowooza	n d o w o o z a
abawala	a b a w a l a
kibuga	k i b u g a
amuzeeyo	a m u z e e y o
zebitundu	z e b i t u n d u
kulambula	k u l a m b u l a
emikolo	e m i k o l o
eyinza	e y i n z a
abakozi	a b a k o z i
ezannya	e z a n n y a
abapangisa	a b a p a n g i s a
ngekimu	n g e k i m u
bassenga	b a s s e n g a
eyonoonye	e y o n o o n y e
zabanoonyiboobubudamu	z a b a n o o n y i b o o b u b u d a m u
omubaka	o m u b a k a
eyimbule	e y i m b u l e
nekyeggulo	n e k y e g g u l o
esembezza	e s e m b e z z a
tugenda	t u g e n d a
birungo	b i r u n g o
kkooti	k k o o t i
awo	a w o
kulinda	k u l i n d a
byabalimi	b y a b a l i m i
maanyi	m a a n y i
okutendeka	o k u t e n d e k a
ekigatta	e k i g a t t a
ekyo	e k y o
wabawala	w a b a w a l a
bonna	b o n n a
ebiwandiikiddwa	e b i w a n d i i k i d d w a
mulekwa	m u l e k w a
gyasigazza	g y a s i g a z z a
nobwakabaka	n o b w a k a b a k a
mateeka	m a t e e k a
bwerazi	b w e r a z i
neddembe	n e d d e m b e
balamu	b a l a m u
oluguudo	o l u g u u d o
okwolesa	o k w o l e s a
abatwalira	a b a t w a l i r a
tetubifunye	t e t u b i f u n y e
baawukane	b a a w u k a n e
bikola	b i k o l a
emabegako	e m a b e g a k o
kontulakiti	k o n t u l a k i t i
okugondera	o k u g o n d e r a
yatongoza	y a t o n g o z a
obusawo	o b u s a w o
abagenda	a b a g e n d a
atukubiriza	a t u k u b i r i z a
kyaffe	k y a f f e
yasoma	y a s o m a
zomukago	z o m u k a g o
okunoonya	o k u n o o n y a
gaggalwa	g a g g a l w a
nabo	n a b o
azannye	a z a n n y e
baana	b a a n a
bategekeddwa	b a t e g e k e d d w a
okuboggola	o k u b o g g o l a
okusinziira	o k u s i n z i i r a
kukulako	k u k u l a k o
university	u n i v e r s i t y
	
bwerivaayo	b w e r i v a a y o
bebitundu	b e b i t u n d u
nga	n g a
gwebyensimbi	g w e b y e n s i m b i
kuleetera	k u l e e t e r a
yenna	y e n n a
ngateekako	n g a t e e k a k o
akimanyidde	a k i m a n y i d d e
emisoso	e m i s o s o
eyeddiiro	e y e d d i i r o
ttooyi	t t o o y i
kulitutwakako	k u l i t u t w a k a k o
okusaba	o k u s a b a
bulaaya	b u l a a y a
oluvannyuma	o l u v a n n y u m a
bulumye	b u l u m y e
enkonge	e n k o n g e
waliwo	w a l i w o
oyo	o y o
omukulu	o m u k u l u
namusobyako	n a m u s o b y a k o
nali	n a l i
atoloka	a t o l o k a
byeetago	b y e e t a g o
gaalemererwa	g a a l e m e r e r w a
kutegeega	k u t e g e e g a
byetaaga	b y e t a a g a
okukulemberamu	o k u k u l e m b e r a m u
okulondoola	o k u l o n d o o l a
litambula	l i t a m b u l a
yabbira	y a b b i r a
paasita	p a a s i t a
ngalo	n g a l o
bamuggyeko	b a m u g g y e k o
obwakabaka	o b w a k a b a k a
agiwulira	a g i w u l i r a
kyabantu	k y a b a n t u
eddembe	e d d e m b e
hajji	h a j j i
terefayina	t e r e f a y i n a
basigala	b a s i g a l a
namazzi	n a m a z z i
ziwoomerwa	z i w o o m e r w a
bunaggya	b u n a g g y a
ako	a k o
avunaanibwa	a v u n a a n i b w a
lirina	l i r i n a
teweereddwa	t e w e e r e d d w a
kalifuuwa	k a l i f u u w a
bye	b y e
okugabana	o k u g a b a n a
okuwumula	o k u w u m u l a
baalowooza	b a a l o w o o z a
kwakolebwa	k w a k o l e b w a
kasooli	k a s o o l i
asasula	a s a s u l a
yeetaagayo	y e e t a a g a y o
na	n a
tagoberedde	t a g o b e r e d d e
bizigo	b i z i g o
ebimutakula	e b i m u t a k u l a
abavuganya	a b a v u g a n y a
zino	z i n o
ekya	e k y a
muddo	m u d d o
eraga	e r a g a
ezo	e z o
bukomyewo	b u k o m y e w o
ekkuumiro	e k k u u m i r o
obwoka	o b w o k a
ezebitundu	e z e b i t u n d u
mateeka	m a t e e k a
emizannyo	e m i z a n n y o
kyennyonyi	k y e n n y o n y i
webuli	w e b u l i
olwokubulankanya	o l w o k u b u l a n k a n y a
ewa	e w a
ffenna	f f e n n a
bange	b a n g e
gyendi	g y e n d i
okukola	o k u k o l a
atukwatirwe	a t u k w a t i r w e
omusajja	o m u s a j j a
okumpuliriza	o k u m p u l i r i z a
kumpi	k u m p i
wababiri	w a b a b i r i
ziba	z i b a
ennyumba	e n n y u m b a
okugula	o k u g u l a
okwewandiisa	o k w e w a n d i i s a
obuwagizi	o b u w a g i z i
ddwaliro	d d w a l i r o
eziwerako	e z i w e r a k o
yavumbagira	y a v u m b a g i r a
ezekyemisana	e z e k y e m i s a n a
abamuddako	a b a m u d d a k o
bameka	b a m e k a
okukolebwa	o k u k o l e b w a
ebisigalira	e b i s i g a l i r a
okumanya	o k u m a n y a
lyobwannannyini	l y o b w a n n a n n y i n i
bwoyiseemu	b w o y i s e e m u
ekimu	e k i m u
emikisa	e m i k i s a
bifo	b i f o
abanoonyiboobubudamu	a b a n o o n y i b o o b u b u d a m u
yasomesezza	y a s o m e s e z z a
bizibu	b i z i b u
eejja	e e j j a
ekiro	e k i r o
egamba	e g a m b a
olwa	o l w a
ddembe	d d e m b e
oyagala	o y a g a l a
ngali	n g a l i
amakulu	a m a k u l u
kusoma	k u s o m a
abasirikirwa	a b a s i r i k i r w a
bwonna	b w o n n a
lwamazaalibwa	l w a m a z a a l i b w a
kutandika	k u t a n d i k a
twetaaga	t w e t a a g a
bw’amaliriza	b w ’ a m a l i r i z a
kunoonyereza	k u n o o n y e r e z a
amakolero	a m a k o l e r o
kwongera	k w o n g e r a
nolukalala	n o l u k a l a l a
tubadde	t u b a d d e
yokuzimba	y o k u z i m b a
ga	g a
banguze	b a n g u z e
mutono	m u t o n o
kuwandiika	k u w a n d i i k a
yendwadde	y e n d w a d d e
okwelabira	o k w e l a b i r a
kasaba	k a s a b a
bimuli	b i m u l i
ebigenda	e b i g e n d a
tulinze	t u l i n z e
okulya	o k u l y a
bwensimbi	b w e n s i m b i
bantu	b a n t u
kulonda	k u l o n d a
yali	y a l i
ezirina	e z i r i n a
okwamazima	o k w a m a z i m a
baaweebwa	b a a w e e b w a
yaawakati	y a a w a k a t i
yokutangiramu	y o k u t a n g i r a m u
asabye	a s a b y e
omusolo	o m u s o l o
kino	k i n o
embuzi	e m b u z i
muwadde	m u w a d d e
baki	b a k i
gwomukwano	g w o m u k w a n o
ewadde	e w a d d e
ajja	a j j a
kukozesebwa	k u k o z e s e b w a
kutegeerebwa	k u t e g e e r e b w a
kwolwo	k w o l w o
yagambibwa	y a g a m b i b w a
namasomero	n a m a s o m e r o
eno	e n o
bino	b i n o
ngagoba	n g a g o b a
mmubuuliremu	m m u b u u l i r e m u
ekito	e k i t o
gayitibwa	g a y i t i b w a
tolina	t o l i n a
sipiika	s i p i i k a
akwate	a k w a t e
baayitamu	b a a y i t a m u
okutondawo	o k u t o n d a w o
omulamuzi	o m u l a m u z i
munnabyabufuzi	m u n n a b y a b u f u z i
genda	g e n d a
muyizi	m u y i z i
okukolaganira	o k u k o l a g a n i r a
bwoku	b w o k u
baalumiziddwa	b a a l u m i z i d d w a
esaba	e s a b a
etadde	e t a d d e
anywako	a n y w a k o
nkulu	n k u l u
zange	z a n g e
ebika	e b i k a
buvudde	b u v u d d e
enseenene	e n s e e n e n e
kufuna	k u f u n a
okutema	o k u t e m a
kifuna	k i f u n a
kyokka	k y o k k a
ezitannabaweebwa	e z i t a n n a b a w e e b w a
erisooka	e r i s o o k a
gankuba	g a n k u b a
kwennyonnyolako	k w e n n y o n n y o l a k o
okutunulamu	o k u t u n u l a m u
tegeka	t e g e k a
lutalo	l u t a l o
bavubuka	b a v u b u k a
beeyunga	b e e y u n g a
nensero	n e n s e r o
bbeeyi	b b e e y i
enkya	e n k y a
baddembe	b a d d e m b e
emigaati	e m i g a a t i
bwobulimi	b w o b u l i m i
olwekirwadde	o l w e k i r w a d d e
lyemirimu	l y e m i r i m u
tulina	t u l i n a
simanyiiyo	s i m a n y i i y o
lyava	l y a v a
abafumbo	a b a f u m b o
nzijanjaba	n z i j a n j a b a
oliguze	o l i g u z e
yatwalibwa	y a t w a l i b w a
olunaku	o l u n a k u
mmalirizza	m m a l i r i z z a
yazaalibwa	y a z a a l i b w a
bavuganya	b a v u g a n y a
ssomero	s s o m e r o
lwobulungi	l w o b u l u n g i
okuteeka	o k u t e e k a
mwebale	m w e b a l e
kweyongera	k w e y o n g e r a
ekiva	e k i v a
amafuta	a m a f u t a
abasabye	a b a s a b y e
lubaale	l u b a a l e
obakyala	o b a k y a l a
longoosebwa	l o n g o o s e b w a
amawanga	a m a w a n g a
ludda	l u d d a
bazira	b a z i r a
wonna	w o n n a
lyabaana	l y a b a a n a
gwabalwadde	g w a b a l w a d d e
ndeeteraayo	n d e e t e r a a y o
obwamabalibwa	o b w a m a b a l i b w a
omuyizi	o m u y i z i
kwokka	k w o k k a
baawadde	b a a w a d d e
y’omulundi	y ’ o m u l u n d i
ssemateeka	s s e m a t e e k a
egendera	e g e n d e r a
memba	m e m b a
okugenda	o k u g e n d a
abakubaganyi	a b a k u b a g a n y i
ensaasaanya	e n s a a s a a n y a
yegulira	y e g u l i r a
ekyokukozesa	e k y o k u k o z e s a
nile	n i l e
yasuula	y a s u u l a
egisukka	e g i s u k k a
yeebazizza	y e e b a z i z z a
abalongoosa	a b a l o n g o o s a
oli	o l i
freehold	f r e e h o l d
amaka	a m a k a
kitubala	k i t u b a l a
kubeera	k u b e e r a
liriwa	l i r i w a
yalidde	y a l i d d e
kugumira	k u g u m i r a
basajja	b a s a j j a
babaggyako	b a b a g g y a k o
kukuumiramu	k u k u u m i r a m u
tiimu	t i i m u
babanjibwa	b a b a n j i b w a
gwa	g w a
ngabantu	n g a b a n t u
yokubudaabuda	y o k u b u d a a b u d a
endagaano	e n d a g a a n o
genguudo	g e n g u u d o
omuddo	o m u d d o
byayo	b y a y o
ruth	r u t h
byebyo	b y e b y o
obutali	o b u t a l i
ennungi	e n n u n g i
yeetaba	y e e t a b a
jjo	j j o
ki	k i
bagezaako	b a g e z a a k o
okukuumibwa	o k u k u u m i b w a
kungaanya	k u n g a a n y a
bwe	b w e
okujjanjabibwa	o k u j j a n j a b i b w a
bannaabwe	b a n n a a b w e
muwandiikiragana	m u w a n d i i k i r a g a n a
gulwayo	g u l w a y o
ekiso	e k i s o
ekole	e k o l e
kwava	k w a v a
alumiziddwa	a l u m i z i d d w a
okusenga	o k u s e n g a
nsinga	n s i n g a
okuzimbibwa	o k u z i m b i b w a
butya	b u t y a
okutumbula	o k u t u m b u l a
nekiwandiiko	n e k i w a n d i i k o
ssentebe	s s e n t e b e
yafumba	y a f u m b a
gaazo	g a a z o
omupiira	o m u p i i r a
ebizimba	e b i z i m b a
ogubadde	o g u b a d d e
kakalu	k a k a l u
ngebya	n g e b y a
bifuna	b i f u n a
okugyoza	o k u g y o z a
wempaka	w e m p a k a
ebitakwatibwa	e b i t a k w a t i b w a
okugoberera	o k u g o b e r e r a
bivujjiridde	b i v u j j i r i d d e
eyali	e y a l i
ekintu	e k i n t u
kyetaago	k y e t a a g o
emirundi	e m i r u n d i
lwenda	l w e n d a
byokka	b y o k k a
ekitongole	e k i t o n g o l e
nabadde	n a b a d d e
kyamawanga	k y a m a w a n g a
teyateekerateekera	t e y a t e e k e r a t e e k e r a
nankwatirako	n a n k w a t i r a k o
ebitafuna	e b i t a f u n a
okkulowoozesa	o k k u l o w o o z e s a
beera	b e e r a
line	l i n e
zi	z i
akutte	a k u t t e
kkampuni	k k a m p u n i
ebikiikirirwa	e b i k i i k i r i r w a
okubaga	o k u b a g a
lwakuba	l w a k u b a
abenkizo	a b e n k i z o
toyagala	t o y a g a l a
batuula	b a t u u l a
okuleetebwa	o k u l e e t e b w a
yaayo	y a a y o
mugattabantu	m u g a t t a b a n t u
okusinga	o k u s i n g a
baalya	b a a l y a
okutaasa	o k u t a a s a
bwabantu	b w a b a n t u
kkapa	k k a p a
omuganda	o m u g a n d a
okuziyiza	o k u z i y i z a
baabazinze	b a a b a z i n z e
mukulu	m u k u l u
yemu	y e m u
tamuliddemu	t a m u l i d d e m u
nzira	n z i r a
ssaati	s s a a t i
machine	m a c h i n e
kirungi	k i r u n g i
bwe	b w e
wabweru	w a b w e r u
kibi	k i b i
ensawo	e n s a w o
nnaku	n n a k u
namutegeera	n a m u t e g e e r a
babadde	b a b a d d e
kwekulula	k w e k u l u l a
batendekeddwa	b a t e n d e k e d d w a
ka	k a
agakumala	a g a k u m a l a
kkwata	k k w a t a
baweebwa	b a w e e b w a
kunoonya	k u n o o n y a
mukazi	m u k a z i
guwooma	g u w o o m a
byakamalirizo	b y a k a m a l i r i z o
obummonde	o b u m m o n d e
emmotoka	e m m o t o k a
okwefunira	o k w e f u n i r a
w’ebyobulamu	w ’ e b y o b u l a m u
yeddira	y e d d i r a
bukwata	b u k w a t a
yandifuna	y a n d i f u n a
mmwe	m m w e
by’ennimi	b y ’ e n n i m i
abalabirira	a b a l a b i r i r a
ssaalumanya	s s a a l u m a n y a
zensi	z e n s i
nefulumya	n e f u l u m y a
nagenda	n a g e n d a
suukaali	s u u k a a l i
yaweereza	y a w e e r e z a
baasuubiza	b a a s u u b i z a
bakola	b a k o l a
abatu	a b a t u
bulamu	b u l a m u
enkya	e n k y a
kawungeezi	k a w u n g e e z i
masomero	m a s o m e r o
wakategeddeko	w a k a t e g e d d e k o
agwana	a g w a n a
okubaka	o k u b a k a
baazuuliddwamu	b a a z u u l i d d w a m u
okwenyigiramu	o k w e n y i g i r a m u
kooti	k o o t i
ngennyama	n g e n n y a m a
aba	a b a
yokwewalamu	y o k w e w a l a m u
namalwaliro	n a m a l w a l i r o
omulala	o m u l a l a
town	t o w n
ebimu	e b i m u
adde	a d d e
lukokola	l u k o k o l a
abapya	a b a p y a
okutuukirira	o k u t u u k i r i r a
yekitongole	y e k i t o n g o l e
eryawamu	e r y a w a m u
kinene	k i n e n e
omukakkamu	o m u k a k k a m u
gwabantu	g w a b a n t u
asoose	a s o o s e
ekikozesa	e k i k o z e s a
omuntu	o m u n t u
twazannya	t w a z a n n y a
kinzijjukiza	k i n z i j j u k i z a
kukola	k u k o l a
sitenseni	s i t e n s e n i
kikolwa	k i k o l w a
zisobola	z i s o b o l a
olusolobyo	o l u s o l o b y o
lyafuna	l y a f u n a
kwalina	k w a l i n a
obukooti	o b u k o o t i
gabalimi	g a b a l i m i
giweebwa	g i w e e b w a
abanoonyi	a b a n o o n y i
nemicungwa	n e m i c u n g w a
abannayuganda	a b a n n a y u g a n d a
ekirwadde	e k i r w a d d e
yatandika	y a t a n d i k a
mukama	m u k a m a
buko	b u k o
alipoota	a l i p o o t a
yalwisibwa	y a l w i s i b w a
ezineetoolodde	e z i n e e t o o l o d d e
bw’akomawo	b w ’ a k o m a w o
bibiina	b i b i i n a
kyenjega	k y e n j e g a
ani	a n i
ekiku	e k i k u
bakimanye	b a k i m a n y e
kupapa	k u p a p a
bamulekwa	b a m u l e k w a
be	b e
ojjukira	o j j u k i r a
babeera	b a b e e r a
zokwawukana	z o k w a w u k a n a
korona	k o r o n a
ngeyisa	n g e y i s a
neeyisa	n e e y i s a
mpozzi	m p o z z i
unesco	u n e s c o
kukuleetera	k u k u l e e t e r a
ttawulo	t t a w u l o
amasannyalaze	a m a s a n n y a l a z e
eyeewaayo	e y e e w a a y o
kiragala	k i r a g a l a
tebannasasulwa	t e b a n n a s a s u l w a
okufumbirwa	o k u f u m b i r w a
abamadi	a b a m a d i
omumyuka	o m u m y u k a
kuteeka	k u t e e k a
omulimu	o m u l i m u
omanya	o m a n y a
nakifuura	n a k i f u u r a
obulamu	o b u l a m u
kabaka	k a b a k a
abagikozesa	a b a g i k o z e s a
baali	b a a l i
gutuuka	g u t u u k a
foomu	f o o m u
lyonna	l y o n n a
entongole	e n t o n g o l e
naluno	n a l u n o
kujja	k u j j a
ekifo	e k i f o
bwenguzi	b w e n g u z i
kiyungu	k i y u n g u
baatuyingiridde	b a a t u y i n g i r i d d e
afuuweeta	a f u u w e e t a
bateekebwa	b a t e e k e b w a
kuliko	k u l i k o
okuggalawo	o k u g g a l a w o
obuwanguzi	o b u w a n g u z i
olukumi	o l u k u m i
mazzi	m a z z i
kyakulya	k y a k u l y a
agaliraanye	a g a l i r a a n y e
egivaamu	e g i v a a m u
womwenkanonkano	w o m w e n k a n o n k a n o
zebitundu	z e b i t u n d u
ekirwadde	e k i r w a d d e
ebikwatagana	e b i k w a t a g a n a
olwebyo	o l w e b y o
kyokuzina	k y o k u z i n a
okutegekawo	o k u t e g e k a w o
siriimu	s i r i i m u
omujjwa	o m u j j w a
kusobola	k u s o b o l a
lyessanyu	l y e s s a n y u
nakkiriza	n a k k i r i z a
tebannatandika	t e b a n n a t a n d i k a
amira	a m i r a
corona	c o r o n a
ssatu	s s a t u
ntambula	n t a m b u l a
z’omukolo	z ’ o m u k o l o
kaseera	k a s e e r a
byona	b y o n a
okugezza	o k u g e z z a
ttivvi	t t i v v i
bulange	b u l a n g e
kulima	k u l i m a
kirudde	k i r u d d e
agakugira	a g a k u g i r a
okugukola	o k u g u k o l a
akantu	a k a n t u
kabonero	k a b o n e r o
bulemenga	b u l e m e n g a
okutangaavu	o k u t a n g a a v u
akyattunka	a k y a t t u n k a
lukungaana	l u k u n g a a n a
kigezo	k i g e z o
leero	l e e r o
bingi	b i n g i
okuwaana	o k u w a a n a
zokuliyirira	z o k u l i y i r i r a
bawadde	b a w a d d e
etikkidde	e t i k k i d d e
taaba	t a a b a
ebalese	e b a l e s e
baasabye	b a a s a b y e
ng’ekirala	n g ’ e k i r a l a
baawa	b a a w a
muntu	m u n t u
mangu	m a n g u
omusaala	o m u s a a l a
wabweru	w a b w e r u
mulimu	m u l i m u
abakulembeze	a b a k u l e m b e z e
akakuubagano	a k a k u u b a g a n o
yebyobufuzi	y e b y o b u f u z i
ngensimbi	n g e n s i m b i
kika	k i k a
omuserikale	o m u s e r i k a l e
ekkovu	e k k o v u
nensi	n e n s i
okutuuka	o k u t u u k a
enguudo	e n g u u d o
egisoba	e g i s o b a
obutuufu	o b u t u u f u
bagamba	b a g a m b a
ttaka	t t a k a
kintu	k i n t u
bituufu	b i t u u f u
y’abyogera	y ’ a b y o g e r a
abalunzi	a b a l u n z i
abayimbi	a b a y i m b i
okukubisibwamu	o k u k u b i s i b w a m u
manvuuli	m a n v u u l i
kusalawo	k u s a l a w o
beetaaga	b e e t a a g a
matu	m a t u
mulembe	m u l e m b e
gano	g a n o
bateekeddwa	b a t e e k e d d w a
kimu	k i m u
gomusaayi	g o m u s a a y i
abakyali	a b a k y a l i
okwanguya	o k w a n g u y a
obutakwatagana	o b u t a k w a t a g a n a
wamu	w a m u
ebintu	e b i n t u
ebyokutambula	e b y o k u t a m b u l a
kkubo	k k u b o
okutikkirwa	o k u t i k k i r w a
covid	c o v i d
kuwasa	k u w a s a
nkomerero	n k o m e r e r o
mbeera	m b e e r a
ngomulwadde	n g o m u l w a d d e
bwokubamu	b w o k u b a m u
kwomwaka	k w o m w a k a
waaliyo	w a a l i y o
ebyetongodde	e b y e t o n g o d d e
omukyala	o m u k y a l a
erongooka	e r o n g o o k a
atambule	a t a m b u l e
okutulugunyizibwa	o k u t u l u g u n y i z i b w a
muno	m u n o
otandika	o t a n d i k a
okuli	o k u l i
omwegendereza	o m w e g e n d e r e z a
ekola	e k o l a
bizinensi	b i z i n e n s i
amasomero	a m a s o m e r o
kulayira	k u l a y i r a
ekyomutawaana	e k y o m u t a w a a n a
engaba	e n g a b a
baakumujjukiranga	b a a k u m u j j u k i r a n g a
agasseeko	a g a s s e e k o
nabalenzi	n a b a l e n z i
akubiriza	a k u b i r i z a
minisitule	m i n i s i t u l e
natandika	n a t a n d i k a
bwogenda	b w o g e n d a
atawanyizibwa	a t a w a n y i z i b w a
akaseera	a k a s e e r a
omulenzi	o m u l e n z i
east	e a s t
nnyo	n n y o
malwaliro	m a l w a l i r o
obungi	o b u n g i
oluganda	o l u g a n d a
kuyingiza	k u y i n g i z a
eyamba	e y a m b a
asobola	a s o b o l a
okweteekamu	o k w e t e e k a m u
lufula	l u f u l a
mmayiro	m m a y i r o
bakambwe	b a k a m b w e
ziyisibwa	z i y i s i b w a
mwagala	m w a g a l a
okuziika	o k u z i i k a
minisita	m i n i s i t a
waggonjebwa	w a g g o n j e b w a
okusemberera	o k u s e m b e r e r a
amulindirako	a m u l i n d i r a k o
ngagguse	n g a g g u s e
wange	w a n g e
yamusaba	y a m u s a b a
bulwadde	b u l w a d d e
ebbiri	e b b i r i
ensi	e n s i
omukozi	o m u k o z i
twatuula	t w a t u u l a
neetaga	n e e t a g a
buna	b u n a
nzija	n z i j a
kiruma	k i r u m a
kansuubire	k a n s u u b i r e
bisatu	b i s a t u
kukuza	k u k u z a
banaabwe	b a n a a b w e
byetaagisa	b y e t a a g i s a
masaka	m a s a k a
abakulembeza	a b a k u l e m b e z a
buyambi	b u y a m b i
gisinga	g i s i n g a
enguzi	e n g u z i
edda	e d d a
muteesa	m u t e e s a
amayinja	a m a y i n j a
kikumi	k i k u m i
omunnyo	o m u n n y o
bulijjo	b u l i j j o
oba	o b a
gaggalawo	g a g g a l a w o
omwenge	o m w e n g e
nalubaale	n a l u b a a l e
bitono	b i t o n o
okukifunamu	o k u k i f u n a m u
buwambe	b u w a m b e
kwayongezeddwayo	k w a y o n g e z e d d w a y o
esasule	e s a s u l e
ezebbeeyi	e z e b b e e y i
bwannannyini	b w a n n a n n y i n i
banoonyerereza	b a n o o n y e r e r e z a
obukugu	o b u k u g u
oludda	o l u d d a
bigezo	b i g e z o
abakungu	a b a k u n g u
abenjawulo	a b e n j a w u l o
magezi	m a g e z i
baayo	b a a y o
mubayambeko	m u b a y a m b e k o
okukomya	o k u k o m y a
tebannazifuna	t e b a n n a z i f u n a
ogwokubba	o g w o k u b b a
tebajja	t e b a j j a
newankubadde	n e w a n k u b a d d e
kimugwanira	k i m u g w a n i r a
baakozesa	b a a k o z e s a
akuulira	a k u u l i r a
nakawangula	n a k a w a n g u l a
katonda	k a t o n d a
bonnabagaggawale	b o n n a b a g a g g a w a l e
abaakosebwa	a b a a k o s e b w a
etunuulirirwa	e t u n u u l i r i r w a
nnabadde	n n a b a d d e
mbirowoozaamu	m b i r o w o o z a a m u
ng’omukadde	n g ’ o m u k a d d e
olina	o l i n a
ebyapa	e b y a p a
okubonaabona	o k u b o n a a b o n a
budde	b u d d e
ebyensimbi	e b y e n s i m b i
gwomuntu	g w o m u n t u
amasiro	a m a s i r o
byokuziika	b y o k u z i i k a
ssenya	s s e n y a
muganzi	m u g a n z i
balwadde	b a l w a d d e
basoma	b a s o m a
zonna	z o n n a
basaana	b a s a a n a
batandise	b a t a n d i s e
nasaba	n a s a b a
ennaku	e n n a k u
royal	r o y a l
obutaliimu	o b u t a l i i m u
kampala	k a m p a l a
ekibiina	e k i b i i n a
beebuuza	b e e b u u z a
nokunoonya	n o k u n o o n y a
kaduukulu	k a d u u k u l u
abagwa	a b a g w a
byobulamu	b y o b u l a m u
erikuumiddwa	e r i k u u m i d d w a
ya	y a
enteekateeka	e n t e e k a t e e k a
abagivuganya	a b a g i v u g a n y a
yayongeddeko	y a y o n g e d d e k o
galemesezza	g a l e m e s e z z a
kulangira	k u l a n g i r a
ebya	e b y a
ekizimbe	e k i z i m b e
bafudde	b a f u d d e
bw	b w
abeera	a b e e r a
lungi	l u n g i
bwereere	b w e r e e r e
ebyokuzimba	e b y o k u z i m b a
mbi	m b i
okutambuza	o k u t a m b u z a
ebirooto	e b i r o o t o
engendo	e n g e n d o
bwaba	b w a b a
omugabo	o m u g a b o
tusaba	t u s a b a
gwejja	g w e j j a
kimuleetera	k i m u l e e t e r a
mitongole	m i t o n g o l e
gw’abakazi	g w ’ a b a k a z i
kisolo	k i s o l o
mpaayo	m p a a y o
tewakikolanga	t e w a k i k o l a n g a
bamulekwa	b a m u l e k w a
bambi	b a m b i
ajagujagu	a j a g u j a g u
be	b e
obuyinike	o b u y i n i k e
olukulu	o l u k u l u
jjangu	j j a n g u
okumala	o k u m a l a
yabadde	y a b a d d e
akakiiko	a k a k i i k o
baabadde	b a a b a d d e
nkungaana	n k u n g a a n a
ebyobuwangwa	e b y o b u w a n g w a
namagye	n a m a g y e
ssaabawolereza	s s a a b a w o l e r e z a
okusitula	o k u s i t u l a
bitongole	b i t o n g o l e
ebirungo	e b i r u n g o
olungereza	o l u n g e r e z a
ekisinga	e k i s i n g a
eddiini	e d d i i n i
enkalu	e n k a l u
yamazzi	y a m a z z i
omukomazi	o m u k o m a z i
abanafu	a b a n a f u
kyokka	k y o k k a
abasoba	a b a s o b a
tegasobola	t e g a s o b o l a
esatu	e s a t u
nsimbi	n s i m b i
engero	e n g e r o
liri	l i r i
ennyonyi	e n n y o n y i
bwamateeka	b w a m a t e e k a
eyobyobulamu	e y o b y o b u l a m u
okutwalibwa	o k u t w a l i b w a
abasomi	a b a s o m i
ebyafaayo	e b y a f a a y o
nebyennyanja	n e b y e n n y a n j a
ensobi	e n s o b i
gya	g y a
kuba	k u b a
eriwo	e r i w o
mangu	m a n g u
nzirugavu	n z i r u g a v u
tugendera	t u g e n d e r a
kwabavubuka	k w a b a v u b u k a
omukungu	o m u k u n g u
onokiyigiriza	o n o k i y i g i r i z a
abaana	a b a a n a
tteeka	t t e e k a
obubi	o b u b i
budde	b u d d e
bbunansi	b b u n a n s i
okugobererwa	o k u g o b e r e r w a
amasanyalaze	a m a s a n y a l a z e
esobozesa	e s o b o z e s a
gwabakozi	g w a b a k o z i
emuliyirire	e m u l i y i r i r e
nnagwedda	n n a g w e d d a
gwebigere	g w e b i g e r e
kumanya	k u m a n y a
toziraba	t o z i r a b a
okwanukula	o k w a n u k u l a
mukuba	m u k u b a
n’addirirwa	n ’ a d d i r i r w a
lya	l y a
tiimi	t i i m i
ge	g e
bamativu	b a m a t i v u
etundibwa	e t u n d i b w a
omuzito	o m u z i t o
laadiyo	l a a d i y o
obululu	o b u l u l u
tetulya	t e t u l y a
sisobola	s i s o b o l a
gyabwo	g y a b w o
lyabwe	l y a b w e
kikuyamba	k i k u y a m b a
alinda	a l i n d a
kyabazinga	k y a b a z i n g a
kukyusa	k u k y u s a
west	w e s t
ttendo	t t e n d o
beesabikira	b e e s a b i k i r a
essimu	e s s i m u
wadda	w a d d a
mugulansigo	m u g u l a n s i g o
ssigala	s s i g a l a
okutandika	o k u t a n d i k a
mikutu	m i k u t u
bwosukka	b w o s u k k a
bannange	b a n n a n g e
nebitundu	n e b i t u n d u
ogwokubiri	o g w o k u b i r i
okukendeeza	o k u k e n d e e z a
babuuzizza	b a b u u z i z z a
bavunaaniddwa	b a v u n a a n i d d w a
obubbi	o b u b b i
butanwa	b u t a n w a
abujje	a b u j j e
mwezi	m w e z i
mirembe	m i r e m b e
musanyufu	m u s a n y u f u
bulungi	b u l u n g i
zandikendeezezza	z a n d i k e n d e e z e z z a
beetegefu	b e e t e g e f u
ebibabudamya	e b i b a b u d a m y a
mufulume	m u f u l u m e
asinga	a s i n g a
ekitabo	e k i t a b o
kyolina	k y o l i n a
ekyaana	e k y a a n a
nnambika	n n a m b i k a
bifulumizibwa	b i f u l u m i z i b w a
okusolobya	o k u s o l o b y a
kye	k y e
agaafiiriddwako	a g a a f i i r i d d w a k o
makerere	m a k e r e r e
abamu	a b a m u
kalantiini	k a l a n t i i n i
bibiina	b i b i i n a
abalwadde	a b a l w a d d e
byonna	b y o n n a
okusika	o k u s i k a
mufumbo	m u f u m b o
nabo	n a b o
okutuusibwa	o k u t u u s i b w a
tanaaba	t a n a a b a
obwenzi	o b w e n z i
enyiriri	e n y i r i r i
bakujjanjabira	b a k u j j a n j a b i r a
akawera	a k a w e r a
gwo	g w o
amazzi	a m a z z i
omugenzi	o m u g e n z i
neyongera	n e y o n g e r a
bubaka	b u b a k a
okutendekebwa	o k u t e n d e k e b w a
era	e r a
eyeesimbyewo	e y e e s i m b y e w o
ono	o n o
abalya	a b a l y a
tetwenkanankana	t e t w e n k a n a n k a n a
kkaddiyizo	k k a d d i y i z o
ebigaaniddwa	e b i g a a n i d d w a
kwabwe	k w a b w e
kyamenvu	k y a m e n v u
ekirabo	e k i r a b o
enkwata	e n k w a t a
ebyemirundi	e b y e m i r u n d i
yakawuka	y a k a w u k a
bwa	b w a
okimanyi	o k i m a n y i
batte	b a t t e
yomwenkanonkano	y o m w e n k a n o n k a n o
ttaano	t t a a n o
yeewaddeyo	y e e w a d d e y o
kkutegeeza	k k u t e g e e z a
musajja	m u s a j j a
bukiikakkono	b u k i i k a k k o n o
balondebwa	b a l o n d e b w a
basabye	b a s a b y e
omuzannyi	o m u z a n n y i
mpanvu	m p a n v u
konsitityusoni	k o n s i t i t y u s o n i
bakansala	b a k a n s a l a
bagannemeredde	b a g a n n e m e r e d d e
sikikusuubira	s i k i k u s u u b i r a
bizinesi	b i z i n e s i
obuyigirize	o b u y i g i r i z e
mpulira	m p u l i r a
nnyonnyola	n n y o n n y o l a
ebyenjigiriza	e b y e n j i g i r i z a
bika	b i k a
okusomesa	o k u s o m e s a
baalyekanze	b a a l y e k a n z e
okola	o k o l a
nnampala	n n a m p a l a
nsaasaana	n s a a s a a n a
y’ekitontome	y ’ e k i t o n t o m e
yakubibwa	y a k u b i b w a
mbalirira	m b a l i r i r a
tusobole	t u s o b o l e
kyejjuuni	k y e j j u u n i
boludda	b o l u d d a
kyonna	k y o n n a
omubbi	o m u b b i
bokulembera	b o k u l e m b e r a
okukulaakulana	o k u k u l a a k u l a n a
mayonjo	m a y o n j o
gwokukuuma	g w o k u k u u m a
ebyabiddwa	e b y a b i d d w a
oteeka	o t e e k a
amberedewo	a m b e r e d e w o
nsimbye	n s i m b y e
okuteekawo	o k u t e e k a w o
obulimi	o b u l i m i
zaffe	z a f f e
nenkola	n e n k o l a
mwenna	m w e n n a
okuteekateeka	o k u t e e k a t e e k a
kakunyumidde	k a k u n y u m i d d e
nzikiriza	n z i k i r i z a
yonna	y o n n a
afumise	a f u m i s e
waggulu	w a g g u l u
tebagwa	t e b a g w a
akyeggyako	a k y e g g y a k o
nsi	n s i
enguzi	e n g u z i
akalango	a k a l a n g o
okwo	o k w o
ayitiwo	a y i t i w o
ayina	a y i n a
nkuba	n k u b a
kusasulwa	k u s a s u l w a
nnunda	n n u n d a
teyita	t e y i t a
nensibuko	n e n s i b u k o
ewera	e w e r a
lunaku	l u n a k u
omusuubira	o m u s u u b i r a
omunaana	o m u n a a n a
ebyeteeseteese	e b y e t e e s e t e e s e
okuyamba	o k u y a m b a
nabantu	n a b a n t u
layisinsi	l a y i s i n s i
amazima	a m a z i m a
katambi	k a t a m b i
okulwanyisa	o k u l w a n y i s a
mirimu	m i r i m u
bekinnansi	b e k i n n a n s i
lwookuna	l w o o k u n a
tutandika	t u t a n d i k a
emikutu	e m i k u t u
baana	b a a n a
olubiri	o l u b i r i
gebisolo	g e b i s o l o
kyaddondo	k y a d d o n d o
lwe	l w e
by’ennimi	b y ’ e n n i m i
nensonga	n e n s o n g a
engeri	e n g e r i
ekkulu	e k k u l u
bitwala	b i t w a l a
kwebiri	k w e b i r i
nomutemu	n o m u t e m u
tezirina	t e z i r i n a
kuyiga	k u y i g a
uganda	u g a n d a
ttiimu	t t i i m u
kibuga	k i b u g a
ebibira	e b i b i r a
libalirirwamu	l i b a l i r i r w a m u
naddala	n a d d a l a
ekikola	e k i k o l a
awe	a w e
yalumbiddwa	y a l u m b i d d w a
etambuza	e t a m b u z a
nabyo	n a b y o
amabeere	a m a b e e r e
ki	k i
emmeeme	e m m e e m e
enkulaakulana	e n k u l a a k u l a n a
okukungaanya	o k u k u n g a a n y a
kyoyagala	k y o y a g a l a
kozessa	k o z e s s a
obwana	o b w a n a
aweese	a w e e s e
bwali	b w a l i
omuzadde	o m u z a d d e
olukyasinze	o l u k y a s i n z e
yakubirizza	y a k u b i r i z z a
kuzaalibwa	k u z a a l i b w a
atatabika	a t a t a b i k a
obuva	o b u v a
tutamanyiiko	t u t a m a n y i i k o
aga	a g a
walina	w a l i n a
kolona	k o l o n a
kusoma	k u s o m a
nabakulembeze	n a b a k u l e m b e z e
entambuza	e n t a m b u z a
nzaalibwa	n z a a l i b w a
ekicupule	e k i c u p u l e
yebyobulamu	y e b y o b u l a m u
mukozi	m u k o z i
nazo	n a z o
ago	a g o
nsowe	n s o w e
abaabalonda	a b a a b a l o n d a
omubeezi	o m u b e e z i
kulaba	k u l a b a
kibuuzo	k i b u u z o
abalimi	a b a l i m i
okusaddaakibwa	o k u s a d d a a k i b w a
okubaawo	o k u b a a w o
wakwekebeza	w a k w e k e b e z a
mutendera	m u t e n d e r a
takyalaba	t a k y a l a b a
byabasawo	b y a b a s a w o
nnambogo	n n a m b o g o
kwotadde	k w o t a d d e
abakurisito	a b a k u r i s i t o
eryo	e r y o
kyaggwamu	k y a g g w a m u
oluddako	o l u d d a k o
ebinazi	e b i n a z i
bitumbuddwa	b i t u m b u d d w a
ekirala	e k i r a l a
bino	b i n o
gulina	g u l i n a
nomalako	n o m a l a k o
gyonna	g y o n n a
olumala	o l u m a l a
akatale	a k a t a l e
akakyo	a k a k y o
wampimira	w a m p i m i r a
kikyuse	k i k y u s e
yeetegese	y e e t e g e s e
ewange	e w a n g e
kizibu	k i z i b u
kitundu	k i t u n d u
tweyagalidde	t w e y a g a l i d d e
okujjumbira	o k u j j u m b i r a
ezobulabe	e z o b u l a b e
okwogera	o k w o g e r a
loole	l o o l e
embiriizi	e m b i r i i z i
lukuzibwa	l u k u z i b w a
gobwannanyini	g o b w a n n a n y i n i
emmere	e m m e r e
ngosika	n g o s i k a
ezigenda	e z i g e n d a
n’olw’ensonga	n ’ o l w ’ e n s o n g a
kibiina	k i b i i n a
tebasaanidde	t e b a s a a n i d d e
tetulina	t e t u l i n a
byenjigiriza	b y e n j i g i r i z a
okukuuma	o k u k u u m a
ebikolwa	e b i k o l w a
babiri	b a b i r i
kyannema	k y a n n e m a
sinnafuna	s i n n a f u n a
biyamba	b i y a m b a
omulabirizi	o m u l a b i r i z i
omubiri	o m u b i r i
okusibwa	o k u s i b w a
omuceere	o m u c e e r e
kwongezebwa	k w o n g e z e b w a
ziwagira	z i w a g i r a
okwogiwaza	o k w o g i w a z a
yagaana	y a g a a n a
n’afuna	n ’ a f u n a
omuli	o m u l i
okuva	o k u v a
ngeddagala	n g e d d a g a l a
kuno	k u n o
buganda	b u g a n d a
galina	g a l i n a
yamuwa	y a m u w a
ezenjawulo	e z e n j a w u l o
kitundu	k i t u n d u
nsuubira	n s u u b i r a
kkondo	k k o n d o
gyokka	g y o k k a
ebirungi	e b i r u n g i
kadde	k a d d e
nedda	n e d d a
tetwalonda	t e t w a l o n d a
bo	b o
yo	y o
fuba	f u b a
ababadde	a b a b a d d e
atandike	a t a n d i k e
y’okubukuumamu	y ’ o k u b u k u u m a m u
gw’ozaaala	g w ’ o z a a a l a
kwekisaawe	k w e k i s a a w e
omubuulizi	o m u b u u l i z i
nnakizuula	n n a k i z u u l a
okuyambibwako	o k u y a m b i b w a k o
kukweka	k u k w e k a
okuwozesa	o k u w o z e s a
kwetabiddwako	k w e t a b i d d w a k o
kusala	k u s a l a
kiwanuka	k i w a n u k a
sitanza	s i t a n z a
abalungi	a b a l u n g i
bwesomye	b w e s o m y e
kigendererwa	k i g e n d e r e r w a
ekisa	e k i s a
gajjanjaba	g a j j a n j a b a
wadde	w a d d e
beerabira	b e e r a b i r a
kutwala	k u t w a l a
empya	e m p y a
baasaba	b a a s a b a
bwabyo	b w a b y o
tegeeza	t e g e e z a
okuwa	o k u w a
mugaso	m u g a s o
tayagala	t a y a g a l a
obuyinza	o b u y i n z a
baagambye	b a a g a m b y e
ekimuggye	e k i m u g g y e
weewola	w e e w o l a
ezokunkya’	e z o k u n k y a ’
gakola	g a k o l a
omulanga	o m u l a n g a
tukuleetedde	t u k u l e e t e d d e
mwetowaze	m w e t o w a z e
tiketi	t i k e t i
ogwo	o g w o
bangi	b a n g i
guno	g u n o
emirembe	e m i r e m b e
muli	m u l i
lw’awulira	l w ’ a w u l i r a
ajjudde	a j j u d d e
mitendera	m i t e n d e r a
okwennaku	o k w e n n a k u
niddwa	n i d d w a
lino	l i n o
girina	g i r i n a
owange	o w a n g e
asukka	a s u k k a
nnyumba	n n y u m b a
olulaga	o l u l a g a
ebikozesebwa	e b i k o z e s e b w a
kumwelabira	k u m w e l a b i r a
bebirowoozo	b e b i r o w o o z o
yesimbyewo	y e s i m b y e w o
omuvubuka	o m u v u b u k a
babiri	b a b i r i
ebanjibwa	e b a n j i b w a
nsonga	n s o n g a
okuzimba	o k u z i m b a
tebasobola	t e b a s o b o l a
yokusaka	y o k u s a k a
gusobola	g u s o b o l a
bijja	b i j j a
okujaguza	o k u j a g u z a
mukuumaddamula	m u k u u m a d d a m u l a
yagasseeko	y a g a s s e e k o
yasabye	y a s a b y e
satu	s a t u
munnabusiro	m u n n a b u s i r o
akabi	a k a b i
gateekebwawo	g a t e e k e b w a w o
tebajjumbira	t e b a j j u m b i r a
okyalina	o k y a l i n a
emirimu	e m i r i m u
kugenda	k u g e n d a
bansobera	b a n s o b e r a
kukulaakulanya	k u k u l a a k u l a n y a
puloogulaamu	p u l o o g u l a a m u
emyaka	e m y a k a
baasabibwa	b a a s a b i b w a
gayina	g a y i n a
ssenyiga	s s e n y i g a
abangi	a b a n g i
okuwona	o k u w o n a
endala	e n d a l a
mulyango	m u l y a n g o
ogwokubiri	o g w o k u b i r i
baagaanira	b a a g a a n i r a
ebirimu	e b i r i m u
enjuki	e n j u k i
ye	y e
empale	e m p a l e
enzimba	e n z i m b a
okubalirira	o k u b a l i r i r a
wo	w o
okunoonyereza	o k u n o o n y e r e z a
ziweze	z i w e z e
biseera	b i s e e r a
ennyo	e n n y o
ekikadde	e k i k a d d e
lye	l y e
kutambula	k u t a m b u l a
mwe	m w e
omuwendo	o m u w e n d o
okugikozesa	o k u g i k o z e s a
bibala	b i b a l a
masomero	m a s o m e r o
wankoko	w a n k o k o
omupiira	o m u p i i r a
obuwanguzi	o b u w a n g u z i
gomesi	g o m e s i
okufa	o k u f a
kituufu	k i t u u f u
abalirira	a b a l i r i r a
kasoobo	k a s o o b o
yetaaga	y e t a a g a
baalaze	b a a l a z e
ennyiriri	e n n y i r i r i
ababeera	a b a b e e r a
bayina	b a y i n a
obukadde	o b u k a d d e
tekinologiya	t e k i n o l o g i y a
eza	e z a
agenda	a g e n d a
siringi	s i r i n g i
nno	n n o
wakamunye	w a k a m u n y e
bwalemererwa	b w a l e m e r e r w a
zebyobufuzi	z e b y o b u f u z i
ekiviirako	e k i v i i r a k o
okusazaamu	o k u s a z a a m u
tosobola	t o s o b o l a
tuli	t u l i
kawempe	k a w e m p e
zokusasula	z o k u s a s u l a
yalemererwa	y a l e m e r e r w a
yafunye	y a f u n y e
okweyimirirwa	o k w e y i m i r i r w a
baafuna	b a a f u n a
teyalina	t e y a l i n a
kuyamba	k u y a m b a
nabasajja	n a b a s a j j a
emboozi	e m b o o z i
gennyumba	g e n n y u m b a
ekiragira	e k i r a g i r a
kukusasula	k u k u s a s u l a
agaffe	a g a f f e
lyebiyiiye	l y e b i y i i y e
bajeemedde	b a j e e m e d d e
envuba	e n v u b a
olusuku	o l u s u k u
etya	e t y a
obulungi	o b u l u n g i
teyozebwa	t e y o z e b w a
eyongere	e y o n g e r e
okwambala	o k w a m b a l a
mukwano	m u k w a n o
ekiwugirwamu	e k i w u g i r w a m u
alyoke	a l y o k e
mpaka	m p a k a
basawo	b a s a w o
omwanawo	o m w a n a w o
maao	m a a o
obutonde	o b u t o n d e
ssaababalirizi	s s a a b a b a l i r i z i
byobugagga	b y o b u g a g g a
ebeera	e b e e r a
nkola	n k o l a
abayiiya	a b a y i i y a
abazadde	a b a z a d d e
nsomesa	n s o m e s a
ayanise	a y a n i s e
okukkiriziganya	o k u k k i r i z i g a n y a
unity	u n i t y
bwamala	b w a m a l a
ngalo	n g a l o
bandekeddewo	b a n d e k e d d e w o
okwera	o k w e r a
ngogyeeko	n g o g y e e k o
bwolaba	b w o l a b a
luvaamu	l u v a a m u
gyetukoma	g y e t u k o m a
obubaka	o b u b a k a
olwakola	o l w a k o l a
kyomuzannyo	k y o m u z a n n y o
abatuuze	a b a t u u z e
bwagambako	b w a g a m b a k o
omusango	o m u s a n g o
yakyukira	y a k y u k i r a
emmere	e m m e r e
bwabanoonyiboobubudamu	b w a b a n o o n y i b o o b u b u d a m u
new	n e w
wasomera	w a s o m e r a
gavumenti	g a v u m e n t i
omuzeeyi	o m u z e e y i
weesanga	w e e s a n g a
bwange	b w a n g e
kirala	k i r a l a
muwogo	m u w o g o
obwegugungo	o b w e g u g u n g o
buganda	b u g a n d a
omuyita	o m u y i t a
obuzireetera	o b u z i r e e t e r a
olulimi	o l u l i m i
okusooka	o k u s o o k a
bakawuka	b a k a w u k a
yansanyusa	y a n s a n y u s a
ebivaamu	e b i v a a m u
zonna	z o n n a
akaddiwa	a k a d d i w a
keeraliikiriza	k e e r a l i i k i r i z a
tebakwatibwa	t e b a k w a t i b w a
egaanye	e g a a n y e
ebirango	e b i r a n g o
ebiragiro	e b i r a g i r o
lwomwana	l w o m w a n a
ggwe	g g w e
baasisinkana	b a a s i s i n k a n a
ky’enva	k y ’ e n v a
obwongo	o b w o n g o
babazza	b a b a z z a
mu	m u
okubirizibwa	o k u b i r i z i b w a
yawaayo	y a w a a y o
kata	k a t a
yaabwe	y a a b w e
z’okusomesa	z ’ o k u s o m e s a
mubiri	m u b i r i
lwa	l w a
akizudde	a k i z u d d e
akalaga	a k a l a g a
abakulu	a b a k u l u
kitangaala	k i t a n g a a l a
kano	k a n o
atulangidde	a t u l a n g i d d e
omukambwe	o m u k a m b w e
kwe	k w e
gye	g y e
amangiempeereza	a m a n g i e m p e e r e z a
kwagala	k w a g a l a
obuto	o b u t o
bwerinde	b w e r i n d e
n’agatalina	n ’ a g a t a l i n a
naawe	n a a w e
amateeka	a m a t e e k a
okukozesa	o k u k o z e s a
ly’omuzannyo	l y ’ o m u z a n n y o
okuzuula	o k u z u u l a
ennyange	e n n y a n g e
bina	b i n a
nti	n t i
muntu	m u n t u
kya	k y a
obwavu	o b w a v u
faayo	f a a y o
neminyolo	n e m i n y o l o
bodaboda	b o d a b o d a
eddoboozi	e d d o b o o z i
kikula	k i k u l a
okugemebwa	o k u g e m e b w a
b”ekibiina	b ” e k i b i i n a
akadde	a k a d d e
omwana	o m w a n a
byayogera	b y a y o g e r a
empapula	e m p a p u l a
kyasobola	k y a s o b o l a
ennyo	e n n y o
ennusu	e n n u s u
ekisooka	e k i s o o k a
woludda	w o l u d d a
gw’ekika	g w ’ e k i k a
embi	e m b i
okusaasaana	o k u s a a s a a n a
omutwe	o m u t w e
ekivuganya	e k i v u g a n y a
ge	g e
yekka	y e k k a
ekitundu	e k i t u n d u
ggulu	g g u l u
ganyirira	g a n y i r i r a
ekisoboka	e k i s o b o k a
liyise	l i y i s e
eddagala	e d d a g a l a
ekkanisa	e k k a n i s a
wekinnansi	w e k i n n a n s i
kironde	k i r o n d e
y’asooka	y ’ a s o o k a
obudde	o b u d d e
mulambo	m u l a m b o
omuwaabi	o m u w a a b i
gwazo	g w a z o
omuduumizi	o m u d u u m i z i
okusoma	o k u s o m a
ebbula	e b b u l a
gwokuvuga	g w o k u v u g a
yatulagira	y a t u l a g i r a
obukuumi	o b u k u u m i
erigenda	e r i g e n d a
okugamba	o k u g a m b a
abassajja	a b a s s a j j a
saba	s a b a
bobubudamu	b o b u b u d a m u
waabwe	w a a b w e
baavaayo	b a a v a a y o
neragira	n e r a g i r a
gwagwe	g w a g w e
amatono	a m a t o n o
omukono	o m u k o n o
agira	a g i r a
abafa	a b a f a
emmere	e m m e r e
okuyimirizaawo	o k u y i m i r i z a a w o
baggala	b a g g a l a
lyatwaliddwa	l y a t w a l i d d w a
mazzi	m a z z i
yolungereza	y o l u n g e r e z a
mulalama	m u l a l a m a
tugenze	t u g e n z e
kuteekebwa	k u t e e k e b w a
obulwadde	o b u l w a d d e
takwagala	t a k w a g a l a
ebisale	e b i s a l e
nnya	n n y a
kit	k i t
ekiddugavu	e k i d d u g a v u
gyetaagisa	g y e t a a g i s a
okwekulaakulanya	o k w e k u l a a k u l a n y a
okimanyi	o k i m a n y i
ateekewo	a t e e k e w o
obuli	o b u l i
kaliisoliiso	k a l i i s o l i i s o
nnaleese	n n a l e e s e
n’amuwa	n ’ a m u w a
amakungula	a m a k u n g u l a
ssomero	s s o m e r o
ofunye	o f u n y e
enzigi	e n z i g i
bui	b u i
nakasi	n a k a s i
kulya	k u l y a
tebitera	t e b i t e r a
bobubuddamu	b o b u b u d d a m u
ze	z e
wansi	w a n s i
amadaala	a m a d a a l a
bbaawe	b b a a w e
siwummula	s i w u m m u l a
empologoma	e m p o l o g o m a
matendekero	m a t e n d e k e r o
nja	n j a
gwensiri	g w e n s i r i
byabwe	b y a b w e
essomero	e s s o m e r o
ngoli	n g o l i
tekirina	t e k i r i n a
platform	p l a t f o r m
kuliko	k u l i k o
embwa	e m b w a
nabanoonyi	n a b a n o o n y i
okujulira	o k u j u l i r a
embi	e m b i
ziriko	z i r i k o
omwezi	o m w e z i
zaabwe	z a a b w e
okutali	o k u t a l i
omubisi	o m u b i s i
nakoma	n a k o m a
mavuunya	m a v u u n y a
londako	l o n d a k o
likwata	l i k w a t a
tuba	t u b a
obulabe	o b u l a b e
goofu	g o o f u
pulojekiti	p u l o j e k i t i
alemeddwa	a l e m e d d w a
ekkubo	e k k u b o
simulaba	s i m u l a b a
etwala	e t w a l a
balungi	b a l u n g i
gava	g a v a
bakubiddwa	b a k u b i d d w a
kyetaaga	k y e t a a g a
musooke	m u s o o k e
yabika	y a b i k a
bali	b a l i
babakozesebwa	b a b a k o z e s e b w a
agenjawulo	a g e n j a w u l o
okusamba	o k u s a m b a
abawere	a b a w e r e
ebizimbe	e b i z i m b e
ebyobusuubuzi	e b y o b u s u u b u z i
nakwo	n a k w o
owamaanyi	o w a m a a n y i
disitulikiti	d i s i t u l i k i t i
ggwanga	g g w a n g a
abazuuliddwamu	a b a z u u l i d d w a m u
eggwanga	e g g w a n g a
obukugu	o b u k u g u
n’asukka	n ’ a s u k k a
nabwo	n a b w o
kasirye	k a s i r y e
ekibadde	e k i b a d d e
balowooza	b a l o w o o z a
buwambe	b u w a m b e
ssimu	s s i m u
okufulumya	o k u f u l u m y a
ebyomukyalo	e b y o m u k y a l o
eya	e y a
enkulaakulana	e n k u l a a k u l a n a
gyozikoledde	g y o z i k o l e d d e
eno	e n o
bazitereka	b a z i t e r e k a
bakusobera	b a k u s o b e r a
yategeka	y a t e g e k a
omunaanaansi	o m u n a a n a a n s i
kyatuukako	k y a t u u k a k o
eminene	e m i n e n e
nnyo	n n y o
katale	k a t a l e
singa	s i n g a
balina	b a l i n a
nteekateeka	n t e e k a t e e k a
omu	o m u
ttano	t t a n o
ataddemu	a t a d d e m u
nabalala	n a b a l a l a
bamukebera	b a m u k e b e r a
obuyambi	o b u y a m b i
simuyamba	s i m u y a m b a
amawooteeri	a m a w o o t e e r i
okwakol	o k w a k o l
guluddewo	g u l u d d e w o
akozesa	a k o z e s a
okukuwoomera	o k u k u w o o m e r a
ggwe	g g w e
mmeka	m m e k a
katyabaga	k a t y a b a g a
bbayibuli	b b a y i b u l i
basaba	b a s a b a
tulya	t u l y a
twakyalira	t w a k y a l i r a
azaalibwa	a z a a l i b w a
kibadde	k i b a d d e
ebivuganya	e b i v u g a n y a
byomubiri	b y o m u b i r i
abiri	a b i r i
ca	c a
eteekeddwa	e t e e k e d d w a
egiwulirwa	e g i w u l i r w a
kwa	k w a
okumalawo	o k u m a l a w o
eziggyayo	e z i g g y a y o
okutwala	o k u t w a l a
mwaka	m w a k a
abaaleeta	a b a a l e e t a
egisinga	e g i s i n g a
ekikajjo	e k i k a j j o
engoye	e n g o y e
goofu	g o o f u
baazibbye	b a a z i b b y e
yakulira	y a k u l i r a
mpale	m p a l e
bitundu	b i t u n d u
bannange	b a n n a n g e
obuka	o b u k a
omuwala	o m u w a l a
okutangira	o k u t a n g i r a
nnina	n n i n a
eyakoze	e y a k o z e
ebinyonyi	e b i n y o n y i
bulamu	b u l a m u
eyatusibwako	e y a t u s i b w a k o
obwedda	o b w e d d a
agamu	a g a m u
zirina	z i r i n a
beekalakaasizza	b e e k a l a k a a s i z z a
kidiba	k i d i b a
batabukidde	b a t a b u k i d d e
mukyala	m u k y a l a
nkoko	n k o k o
likaawa	l i k a a w a
kwakawuka	k w a k a w u k a
ebitooke	e b i t o o k e
ekyebitaano	e k y e b i t a a n o
enkungaana	e n k u n g a a n a
byobutonde	b y o b u t o n d e
nkambi	n k a m b i
ekisigaddeyo	e k i s i g a d d e y o
waggyeeko	w a g g y e e k o
kiwambabantu	k i w a m b a b a n t u
zamasomero	z a m a s o m e r o
kwatandika	k w a t a n d i k a
bannayuganda	b a n n a y u g a n d a
ogujja	o g u j j a
womwana	w o m w a n a
alinze	a l i n z e
ebyobulamu	e b y o b u l a m u
bamakanika	b a m a k a n i k a
okwetegereza	o k w e t e g e r e z a
akola	a k o l a
gwange	g w a n g e
ngakaaba	n g a k a a b a
nagalulira	n a g a l u l i r a
obuwumbi	o b u w u m b i
bwali	b w a l i
nnanyini	n n a n y i n i
nabambejja	n a b a m b e j j a
asiwa	a s i w a
obupande	o b u p a n d e
ntaddeko	n t a d d e k o
lwange	l w a n g e
okuba	o k u b a
abayita	a b a y i t a
okwewalibwa	o k w e w a l i b w a
etya	e t y a
kyonna	k y o n n a
erabika	e r a b i k a
ssekinnoomu	s s e k i n n o o m u
okuzaala	o k u z a a l a
omukambwe	o m u k a m b w e
eyavaako	e y a v a a k o
eddaabiriza	e d d a a b i r i z a
twasembayo	t w a s e m b a y o
kye	k y e
mwogenda	m w o g e n d a
bamukyawa	b a m u k y a w a
koboko	k o b o k o
amawulire	a m a w u l i r e
kuzannya	k u z a n n y a
nengoye	n e n g o y e
yitira	y i t i r a
omukago	o m u k a g o
enkolagana	e n k o l a g a n a
ntensibe	n t e n s i b e
kutumbula	k u t u m b u l a
ensonga	e n s o n g a
ezebikyupuli	e z e b i k y u p u l i
baategeezezza	b a a t e g e e z e z z a
basasulwa	b a s a s u l w a
emmere	e m m e r e
abakola	a b a k o l a
eziri	e z i r i
ebyobutujju	e b y o b u t u j j u
katonda	k a t o n d a
bumu	b u m u
wekyalo	w e k y a l o
yakola	y a k o l a
ebyemizannyo	e b y e m i z a n n y o
ofunamu	o f u n a m u
asuubirwa	a s u u b i r w a
ayinza	a y i n z a
emiti	e m i t i
kutendekebwa	k u t e n d e k e b w a
kufumbirwa	k u f u m b i r w a
ddala	d d a l a
mulekwa	m u l e k w a
wakoze	w a k o z e
bibalirirwa	b i b a l i r i r w a
nasalawo	n a s a l a w o
ennyindo	e n n y i n d o
kukozeseza	k u k o z e s e z a
obutonde	o b u t o n d e
ensangi	e n s a n g i
kyalo	k y a l o
bya	b y a
yasaba	y a s a b a
byuma	b y u m a
okuyimirizaawo	o k u y i m i r i z a a w o
gwabwe	g w a b w e
nnazireka	n n a z i r e k a
agalina	a g a l i n a
boogera	b o o g e r a
byenfuna	b y e n f u n a
nnyingi	n n y i n g i
okumulya	o k u m u l y a
enkaayana	e n k a a y a n a
zamawulire	z a m a w u l i r e
awalonderwa	a w a l o n d e r w a
okugabira	o k u g a b i r a
olubuto	o l u b u t o
embalirira	e m b a l i r i r a
gasiima	g a s i i m a
lyani	l y a n i
luba	l u b a
abasomesa	a b a s o m e s a
omwami	o m w a m i
tebabadde	t e b a b a d d e
emukyusa	e m u k y u s a
bakulembera	b a k u l e m b e r a
ana	a n a
kikozesebwa	k i k o z e s e b w a
emenyese	e m e n y e s e
ebisago	e b i s a g o
gy’akolokota	g y ’ a k o l o k o t a
baakwatibwa	b a a k w a t i b w a
bakulembeze	b a k u l e m b e z e
ekyokubagaana	e k y o k u b a g a a n a
kabonera	k a b o n e r a
kwennima	k w e n n i m a
kitongole	k i t o n g o l e
wabakadde	w a b a k a d d e
omuliro	o m u l i r o
yayanjudde	y a y a n j u d d e
obukookolo	o b u k o o k o l o
okubaako	o k u b a a k o
bivujjirirwa	b i v u j j i r i r w a
biroole	b i r o o l e
agamba	a g a m b a
atuwadde	a t u w a d d e
musaala	m u s a a l a
gutuukana	g u t u u k a n a
ebiteeso	e b i t e e s o
eyambye	e y a m b y e
ngomuzira	n g o m u z i r a
ddi	d d i
abasalawo	a b a s a l a w o
omusomesa	o m u s o m e s a
ekirala	e k i r a l a
kinaana	k i n a a n a
abalala”	a b a l a l a ”
okusanga	o k u s a n g a
kufuuyira	k u f u u y i r a
ssengenge	s s e n g e n g e
yendya	y e n d y a
bano	b a n o
okukeberebwa	o k u k e b e r e b w a
mwesimbu	m w e s i m b u
okukikozesa	o k u k i k o z e s a
yayimiriza	y a y i m i r i z a
omukka	o m u k k a
atya	a t y a
boobubudamu	b o o b u b u d a m u
kitaawe	k i t a a w e
avujjirira	a v u j j i r i r a
ttulakita	t t u l a k i t a
okudda	o k u d d a
okwogeramu	o k w o g e r a m u
ma	m a
njambalirawo	n j a m b a l i r a w o
amaduuka	a m a d u u k a
yatoloka	y a t o l o k a
wamawanga	w a m a w a n g a
tusuubira	t u s u u b i r a
omuwanguzi	o m u w a n g u z i
ngessimu	n g e s s i m u
ebifo	e b i f o
mugwoze	m u g w o z e
wansi	w a n s i
yeetuze	y e e t u z e
0	0
omuzannyo	o m u z a n n y o
kumulesa	k u m u l e s a
yamulaba	y a m u l a b a
ngero	n g e r o
lukale	l u k a l e
gutuleetera	g u t u l e e t e r a
eddwaliro	e d d w a l i r o
kkubbo	k k u b b o
auto	a u t o
bakizuula	b a k i z u u l a
natuula	n a t u u l a
ebirala	e b i r a l a
okusomesebwa	o k u s o m e s e b w a
bwobwongo	b w o b w o n g o
basasulwa	b a s a s u l w a
ettaka	e t t a k a
obwo	o b w o
gamala	g a m a l a
baagenda	b a a g e n d a
bubi	b u b i
akulira	a k u l i r a
gewange	g e w a n g e
ebiri	e b i r i
bamagye	b a m a g y e
bammemba	b a m m e m b a
ttukuttuku	t t u k u t t u k u
amagatte	a m a g a t t e
byabalwadde	b y a b a l w a d d e
buteesa	b u t e e s a
ebavuga	e b a v u g a
nnabikoowa	n n a b i k o o w a
omukulembeze	o m u k u l e m b e z e
eyolukoba	e y o l u k o b a
bumenyi	b u m e n y i
nkuyege	n k u y e g e
emigaso	e m i g a s o
kutuula	k u t u u l a
akali	a k a l i
ssi	s s i
byotamanyi	b y o t a m a n y i
akazannyo	a k a z a n n y o
kaseera	k a s e e r a
yensimbi	y e n s i m b i
obumanyifu	o b u m a n y i f u
ebisolo	e b i s o l o
binyebwa	b i n y e b w a
natwalibwa	n a t w a l i b w a
ssente	s s e n t e
ababaka	a b a b a k a
abavuzi	a b a v u z i
asubwa	a s u b w a
lwokubiri	l w o k u b i r i
gyemiyembe	g y e m i y e m b e
yayita	y a y i t a
gebweru	g e b w e r u
n’amaka	n ’ a m a k a
ntadde	n t a d d e
nabuuka	n a b u u k a
gavumenti	g a v u m e n t i
lwakubayo	l w a k u b a y o
ebikozesebwa	e b i k o z e s e b w a
teekako	t e e k a k o
gwandibadde	g w a n d i b a d d e
ekikopo	e k i k o p o
tegalina	t e g a l i n a
bulijjo	b u l i j j o
birungi	b i r u n g i
wa	w a
abaazeerimira	a b a a z e e r i m i r a
pulezidenti	p u l e z i d e n t i
abavubuka	a b a v u b u k a
bimuzza	b i m u z z a
embeera	e m b e e r a
okubangula	o k u b a n g u l a
abagagga	a b a g a g g a
weddira	w e d d i r a
guno	g u n o
bateekwa	b a t e e k w a
byalimu	b y a l i m u
butuufu	b u t u u f u
zigenda	z i g e n d a
akubye	a k u b y e
obujjanjabi	o b u j j a n j a b i
pulogulaamu	p u l o g u l a a m u
bajjanjabamu	b a j j a n j a b a m u
wessomero	w e s s o m e r o
egiwera	e g i w e r a
barracks	b a r r a c k s
wamma	w a m m a
okukolagana	o k u k o l a g a n a
okuwuliriza	o k u w u l i r i z a
ffe	f f e
okuzeenyigiramu	o k u z e e n y i g i r a m u
muganda	m u g a n d a
ndwadde	n d w a d d e
nnyo	n n y o
bafunye	b a f u n y e
ogeraageranye	o g e r a a g e r a n y e
yomuntu	y o m u n t u
emboga	e m b o g a
disitulikiti	d i s i t u l i k i t i
kitegeeza	k i t e g e e z a
omwaka	o m w a k a
kyaffe	k y a f f e
bakungu	b a k u n g u
aboludda	a b o l u d d a
liba	l i b a
enjala	e n j a l a
amasomero	a m a s o m e r o
moyo	m o y o
ebitusomooza	e b i t u s o m o o z a
kwekuba	k w e k u b a
okutuusa	o k u t u u s a
oguwedde	o g u w e d d e
yalina	y a l i n a
kingi	k i n g i
kukubirizibwa	k u k u b i r i z i b w a
eziweebwa	e z i w e e b w a
beefula	b e e f u l a
bwagwo	b w a g w o
obutategeeraganagana	o b u t a t e g e e r a g a n a g a n a
mulala	m u l a l a
nolupapula	n o l u p a p u l a
okukirizza	o k u k i r i z z a
g’abantu	g ’ a b a n t u
poliisi	p o l i i s i
abayizi	a b a y i z i
buvuddeko	b u v u d d e k o
n’embiro	n ’ e m b i r o
nedda	n e d d a
bumativu	b u m a t i v u
yakukolera	y a k u k o l e r a
oyinza	o y i n z a
bannabyabufuzi	b a n n a b y a b u f u z i
oluyimba	o l u y i m b a
ekyetaagisa	e k y e t a a g i s a
so	s o
olukangaga	o l u k a n g a g a
mukaaga	m u k a a g a
ebibinja	e b i b i n j a
osobola	o s o b o l a
ziri	z i r i
yawadde	y a w a d d e
ngayagala	n g a y a g a l a
ebyennaku	e b y e n n a k u
birime	b i r i m e
yamanda	y a m a n d a
akatono	a k a t o n o
ejja	e j j a
bwomukulembeze	b w o m u k u l e m b e z e
mingi	m i n g i
pulofeesa	p u l o f e e s a
abasigadde	a b a s i g a d d e
nyingi	n y i n g i
ensimbi	e n s i m b i
ewaabwe	e w a a b w e
baazimbudde	b a a z i m b u d d e
bu	b u
paalamenti	p a a l a m e n t i
eziddukanya	e z i d d u k a n y a
eddene	e d d e n e
gumu	g u m u
abalenzi	a b a l e n z i
olwo	o l w o
ennyanja	e n n y a n j a
nkwaso	n k w a s o
pulogula	p u l o g u l a
mbaata	m b a a t a
amakumi	a m a k u m i
temulina	t e m u l i n a
za	z a
kulemera	k u l e m e r a
emyoyo	e m y o y o
okulunda	o k u l u n d a
abuuza	a b u u z a
okutulugunya	o k u t u l u g u n y a
amakanisa	a m a k a n i s a
‘ababbi	‘ a b a b b i
kirina	k i r i n a
kyokugenda	k y o k u g e n d a
okwesumulula	o k w e s u m u l u l a
emitendera	e m i t e n d e r a
okujja	o k u j j a
bafa	b a f a
kyabwe	k y a b w e
kusoboka	k u s o b o k a
kakazigizigi	k a k a z i g i z i g i
yakyusa	y a k y u s a
si	s i
okubayamba	o k u b a y a m b a
bandibadde	b a n d i b a d d e
ayagala	a y a g a l a
gyabantu	g y a b a n t u
enkulu	e n k u l u
ebitone	e b i t o n e
kulinnya	k u l i n n y a
okunyigirizibwa	o k u n y i g i r i z i b w a
zabayizi	z a b a y i z i
kampala	k a m p a l a
eddagala	e d d a g a l a
bivunaanyizibwa	b i v u n a a n y i z i b w a
bifu	b i f u
egyasooka	e g y a s o o k a
ebizibu	e b i z i b u
zitambuza	z i t a m b u z a
baayo	b a a y o
nabakozi	n a b a k o z i
obukulu	o b u k u l u
amakakali	a m a k a k a l i
lukiiko	l u k i i k o
bambega	b a m b e g a
bavuba	b a v u b a
abajulizi	a b a j u l i z i
n’ebirala	n ’ e b i r a l a
kukendeeza	k u k e n d e e z a
ebikyalemedde	e b i k y a l e m e d d e
butono	b u t o n o
basaakiriza	b a s a a k i r i z a
amagezi	a m a g e z i
kati	k a t i
bamuggyeyo	b a m u g g y e y o
zekinnansi	z e k i n n a n s i
byomujjuzo	b y o m u j j u z o
ebyenkizo	e b y e n k i z o
yalafuubana	y a l a f u u b a n a
ogusooka	o g u s o o k a
basimbye	b a s i m b y e
bbaasi	b b a a s i
nkukubira	n k u k u b i r a
ne	n e
essomero	e s s o m e r o
enkuba	e n k u b a
ennyonnyole	e n n y o n n y o l e
yabuulirira	y a b u u l i r i r a
akakira	a k a k i r a
ebirina	e b i r i n a
okweyisiza	o k w e y i s i z a
egaziye	e g a z i y e
ebivuga	e b i v u g a
kukulira	k u k u l i r a
kulabagana	k u l a b a g a n a
obulala	o b u l a l a
bingi	b i n g i
tasaanye	t a s a a n y e
nanakuwala	n a n a k u w a l a
ngumu	n g u m u
luggya	l u g g y a
omusawo	o m u s a w o
olwobutaba	o l w o b u t a b a
omulundi	o m u l u n d i
ezolukale	e z o l u k a l e
byabwe	b y a b w e
nze	n z e
mukama	m u k a m a
obutaagala	o b u t a a g a l a
sigenda	s i g e n d a
agoomunda	a g o o m u n d a
bikwatagana	b i k w a t a g a n a
ddala	d d a l a
esobola	e s o b o l a
ennyama	e n n y a m a
bazze	b a z z e
kisaganda	k i s a g a n d a
enfaanana	e n f a a n a n a
enkofu	e n k o f u
omupya	o m u p y a
okusalawo	o k u s a l a w o
musaabaze	m u s a a b a z e
ndiga	n d i g a
ezebitundu	e z e b i t u n d u
okuwulira	o k u w u l i r a
abato	a b a t o
mirembe	m i r e m b e
dda	d d a
busobola	b u s o b o l a
olaba	o l a b a
yansisinkana	y a n s i s i n k a n a
eggye	e g g y e
gukendeddeko	g u k e n d e d d e k o
gwabasawo	g w a b a s a w o
tayinza	t a y i n z a
namaterekero	n a m a t e r e k e r o
etuuse	e t u u s e
bwabwe	b w a b w e
ebyenjawulo	e b y e n j a w u l o
erimu	e r i m u
mawokota	m a w o k o t a
ssebuggwawo	s s e b u g g w a w o
byabaganda	b y a b a g a n d a
wabasumba	w a b a s u m b a
byobulimi	b y o b u l i m i
kugasa	k u g a s a
munno	m u n n o
eby’ekibiina	e b y ’ e k i b i i n a
kiri	k i r i
olwaleero	o l w a l e e r o
okulemererwa	o k u l e m e r e r w a
amakufulu	a m a k u f u l u
agambye	a g a m b y e
muwendo	m u w e n d o
ebyasibwawo	e b y a s i b w a w o
bakyetaba	b a k y e t a b a
kyalo	k y a l o
kiyamba	k i y a m b a
endya	e n d y a
nkulabe	n k u l a b e
ebikaabya	e b i k a a b y a
emisana	e m i s a n a
ennene	e n n e n e
ddagala	d d a g a l a
asimbibwa	a s i m b i b w a
yeemu	y e e m u
ebikolebwamu	e b i k o l e b w a m u
kubadde	k u b a d d e
ngobulamu	n g o b u l a m u
ngebyassente	n g e b y a s s e n t e
ssebo	s s e b o
empavu	e m p a v u
beebaza	b e e b a z a
ereme	e r e m e
eweddemu	e w e d d e m u
ssomero	s s o m e r o
ssenyonga	s s e n y o n g a
lukumi	l u k u m i
loodimmeeya	l o o d i m m e e y a
ezebyobulamu	e z e b y o b u l a m u
amagye	a m a g y e
mmeka	m m e k a
nankabirwa	n a n k a b i r w a
ebibuuzo	e b i b u u z o
ekyo	e k y o
ekwasise	e k w a s i s e
kukola	k u k o l a
bulungi	b u l u n g i
abana	a b a n a
mbwa	m b w a
bwagobereranga	b w a g o b e r e r a n g a
amalwaliro	a m a l w a l i r o
ekingi	e k i n g i
pulasitiika	p u l a s i t i i k a
luwummula	l u w u m m u l a
biyambye	b i y a m b y e
tegikozesebwa	t e g i k o z e s e b w a
mmotoka	m m o t o k a
kaali	k a a l i
ekinnumya	e k i n n u m y a
enjovu	e n j o v u
abalabe	a b a l a b e
mikono	m i k o n o
ssimu	s s i m u
ekitundu	e k i t u n d u
kulina	k u l i n a
tukyayogera	t u k y a y o g e r a
poliisi	p o l i i s i
kibeera	k i b e e r a
okumulaba	o k u m u l a b a
okubeera	o k u b e e r a
piki	p i k i
nnamugambye	n n a m u g a m b y e
eyaawakati	e y a a w a k a t i
kweraga	k w e r a g a
abasawo	a b a s a w o
enkwa	e n k w a
yaziikiddwa	y a z i i k i d d w a
mengo	m e n g o
weetaaga	w e e t a a g a
n’ebigezo	n ’ e b i g e z o
yagambye	y a g a m b y e
ekirungi	e k i r u n g i
banoonyeza	b a n o o n y e z a
namulaba	n a m u l a b a
wano	w a n o
bennono	b e n n o n o
byabantu	b y a b a n t u
abaabwe	a b a a b w e
okulaba	o k u l a b a
obwavu	o b w a v u
oluwanvu	o l u w a n v u
mbuto	m b u t o
ekulaakulana	e k u l a a k u l a n a
kiseera	k i s e e r a
ebyaweebwa	e b y a w e e b w a
oluusi	o l u u s i
gyogyagalamu	g y o g y a g a l a m u
gali	g a l i
wange	w a n g e
nafa	n a f a
teller	t e l l e r
kabuga	k a b u g a
makanika	m a k a n i k a
abebyobulamu	a b e b y o b u l a m u
kyetaagisa	k y e t a a g i s a
zinnaffe	z i n n a f f e
bulungi	b u l u n g i
omukazi	o m u k a z i
bomu	b o m u
e	e
yaleero	y a l e e r o
zeetaaga	z e e t a a g a
yazikidde	y a z i k i d d e
gwokubaka	g w o k u b a k a
bessomero	b e s s o m e r o
gwensiri	g w e n s i r i
abekisa	a b e k i s a
bateekateeka	b a t e e k a t e e k a
emisolo	e m i s o l o
bweru	b w e r u
ekitone	e k i t o n e
abawagizi	a b a w a g i z i
okulonda	o k u l o n d a
yange	y a n g e
tosaanye	t o s a a n y e
baatambulanga	b a a t a m b u l a n g a
vision	v i s i o n
otya	o t y a
tombuulira	t o m b u u l i r a
ng’erinnya	n g ’ e r i n n y a
maanyi	m a a n y i
ebyenkizo	e b y e n k i z o
omwenyi	o m w e n y i
njagala	n j a g a l a
nabazzukulu	n a b a z z u k u l u
ebiwuka	e b i w u k a
ebibuuzo	e b i b u u z o
eziziyiza	e z i z i y i z a
yansobera	y a n s o b e r a
wotuukira	w o t u u k i r a
ebiragiro	e b i r a g i r o
tetuyina	t e t u y i n a
gobwanannyini	g o b w a n a n n y i n i
zirabika	z i r a b i k a
nsi	n s i
akabanje	a k a b a n j e
nnewuunya	n n e w u u n y a
woofiisi	w o o f i i s i
essasi	e s s a s i
nokuzaala	n o k u z a a l a
omukambwe	o m u k a m b w e
obusookera	o b u s o o k e r a
bakenuzi	b a k e n u z i
abakugu	a b a k u g u
okuvaamu	o k u v a a m u
zokka	z o k k a
okukakasa	o k u k a k a s a
olwobuyambi	o l w o b u y a m b i
yekinnansi	y e k i n n a n s i
noyo	n o y o
musango	m u s a n g o
giremesezza	g i r e m e s e z z a
mutwe	m u t w e
ezivujjiriddwa	e z i v u j j i r i d d w a
kukakibwa	k u k a k i b w a
kusenga	k u s e n g a
nagwo	n a g w o
zino	z i n o
gwe	g w e
bwo	b w o
akadde	a k a d d e
mpaka	m p a k a
kiriko	k i r i k o
gwenkaka	g w e n k a k a
mubi	m u b i
bakwenyumirizaamu	b a k w e n y u m i r i z a a m u
mawanga	m a w a n g a
byo	b y o
gw’abaana	g w ’ a b a a n a
yagenda	y a g e n d a
ekyomukisa	e k y o m u k i s a
balagajjalirwa	b a l a g a j j a l i r w a
kusasula	k u s a s u l a
ziyambye	z i y a m b y e
ensa	e n s a
njeru	n j e r u
kunaaba	k u n a a b a
nobubbi	n o b u b b i
obuzibu	o b u z i b u
sirikanga	s i r i k a n g a
ebiri	e b i r i
abalala	a b a l a l a
awamu	a w a m u
bino	b i n o
kutambuza	k u t a m b u z a
zino	z i n o
egimenya	e g i m e n y a
kuziteeka	k u z i t e e k a
twebuuzaako	t w e b u u z a a k o
lunaku	l u n a k u
baagambiddwa	b a a g a m b i d d w a
ebitongole	e b i t o n g o l e
nggaali	n g g a a l i
zemipiira	z e m i p i i r a
nsoma	n s o m a
gamala	g a m a l a
nokulunda	n o k u l u n d a
baasiima	b a a s i i m a
entangawuuzi	e n t a n g a w u u z i
kusooka	k u s o o k a
etuweereddwa	e t u w e e r e d d w a
zobukaba	z o b u k a b a
yeriwa	y e r i w a
amawagala	a m a w a g a l a
basonze	b a s o n z e
yinginiya	y i n g i n i y a
okusobola	o k u s o b o l a
tebyawera	t e b y a w e r a
wo	w o
otera	o t e r a
zettaka	z e t t a k a
wabula	w a b u l a
bisobola	b i s o b o l a
entebe	e n t e b e
balwadde	b a l w a d d e
abasenga	a b a s e n g a
bataano	b a t a a n o
kizze	k i z z e
omulambo	o m u l a m b o
kye	k y e
tumumma	t u m u m m a
byalo	b y a l o
kkojja	k k o j j a
abantu	a b a n t u
muleese	m u l e e s e
g’ekisajja	g ’ e k i s a j j a
zo	z o
weggwannga	w e g g w a n n g a
zaali	z a a l i
eweereddwa	e w e e r e d d w a
ebola	e b o l a
maama	m a a m a
okulima	o k u l i m a
kabamba	k a b a m b a
eyo	e y o
okukyuka	o k u k y u k a
teyebalirira	t e y e b a l i r i r a
kwessomero	k w e s s o m e r o
okuyita	o k u y i t a
ko	k o
njuba	n j u b a
amaanyi	a m a a n y i
national	n a t i o n a l
obumu	o b u m u
mutukoledde	m u t u k o l e d d e
omukazi	o m u k a z i
tatiddeemu	t a t i d d e e m u
obukodyo	o b u k o d y o
kubuuza	k u b u u z a
abakyala	a b a k y a l a
okumeggana	o k u m e g g a n a
ekyokuddamu	e k y o k u d d a m u
obulwadde	o b u l w a d d e
ntobazi	n t o b a z i
naye	n a y e
baagala	b a a g a l a
tewaaliwo	t e w a a l i w o
kennyini	k e n n y i n i
ateeberezebwa	a t e e b e r e z e b w a
gyamawulire	g y a m a w u l i r e
ebiyonjo	e b i y o n j o
ziteeka	z i t e e k a
zaanise	z a a n i s e
ebizimbe	e b i z i m b e
omungi	o m u n g i
ogwokuva	o g w o k u v a
ennyingiko	e n n y i n g i k o
gukaawa	g u k a a w a
uganda	u g a n d a
bannamateeka	b a n n a m a t e e k a
yabayizi	y a b a y i z i
kkubo	k k u b o
nekkiriza	n e k k i r i z a
bayinza	b a y i n z a
kino	k i n o
ebiyenje	e b i y e n j e
alukweka	a l u k w e k a
kye	k y e
omuzannyo	o m u z a n n y o
akikkaatirizza	a k i k k a a t i r i z z a
zempapula	z e m p a p u l a
bi	b i
bukadde	b u k a d d e
tewali	t e w a l i
minene	m i n e n e
okwegugunga	o k w e g u g u n g a
lugogo	l u g o g o
omubi	o m u b i
etuulako	e t u u l a k o
wakati	w a k a t i
eri	e r i
ekikubo	e k i k u b o
kirwadde	k i r w a d d e
emalirizza	e m a l i r i z z a
ebyuuma	e b y u u m a
ngabakazi	n g a b a k a z i
mangi	m a n g i
yasazizzaamu	y a s a z i z z a a m u
bigambo	b i g a m b o
weesalirawo	w e e s a l i r a w o
tubeebaza	t u b e e b a z a
okutandikibwako	o k u t a n d i k i b w a k o
n’oluswayiri	n ’ o l u s w a y i r i
eryobwebange	e r y o b w e b a n g e
zijja	z i j j a
yandiddidde	y a n d i d d i d d e
banka	b a n k a
institute	i n s t i t u t e
mukazi	m u k a z i
ekyali	e k y a l i
byomu	b y o m u
dipulooma	d i p u l o o m a
kiba	k i b a
eyokuweerezaamu	e y o k u w e e r e z a a m u
abakulisitaayo	a b a k u l i s i t a a y o
luno	l u n o
baawangula	b a a w a n g u l a
baamukutte	b a a m u k u t t e
olugezigezi	o l u g e z i g e z i
bannamawulire	b a n n a m a w u l i r e
ebyo	e b y o
bintu	b i n t u
gebyensoma	g e b y e n s o m a
bataasa	b a t a a s a
kyandibadde	k y a n d i b a d d e
namalirirdde	n a m a l i r i r d d e
nendwadde	n e n d w a d d e
olugero	o l u g e r o
yusuf	y u s u f
ekyakawuka	e k y a k a w u k a
mulamu	m u l a m u
yaliko	y a l i k o
